#本表聲旁及轄字無重覆。
⺽	⺽䳔閰
〇	〇
㐁	㐁
㐄	㐄
㐬	㐬䖻旒毓流琉瑬硫裗
㐭	㐭凛凜壈廩廪懍懔檁燣燷癛禀稟顲
㐱	㐱䪾抮殄沴珍畛疹眕紾胗袗診诊趁跈軫轸飻餮駗
㒸	㒸䃍䉌䯟坠墜鐆队隊
㒼	㒼䊟䝡䤍慲懑懣樠满滿璊瞒瞞蹒蹣鏋顢颟鬗
㓞	㓞㝣㼤䐼䝟䥛䫔䱮偰啮喫契挈揳栔楔潔猰瘛禊稧窫絜葜蛪褉觢鍥锲齧
㓹	㓹瀱罽蘮
㔷	㔷陋
㔾	䈈圮妃嶏淝肥萉蜰配
㕞	㕞刷唰涮
㕟	㕟䈛蒯
㕡	㕡壑
㕢	㒠㕢䪥瀣薤韰
㕣	㔯㕣㳂沿舩船鈆鉛铅
㕦	㕦
㗊	㗊
㘝	㘝笝
㚅	㚅䃧䥢癃窿隆霳
㚇	㚇㣭䁓䎫堫嵕椶猣稯糉緵翪艐葼蝬騣鬉鬷鯼
㚒	㚒陕陝
㚔	㚔
㚘	㚘
㝵	㝵㥂㧹䎪䙷得棏淂
㞋	㜛㞋㫱㬄㼱嫩赧軟软
㞢	㞢
㞷	㞷往暀
㠭	㠭
㠯	㠯䬮以似佀姒泤耜苡苢
㡀	㡀㢼䘷䭱䳤
㡭	㡭檵繼继
㡲	㡲
㡿	泝訴诉
㣇	㣇㣈肂肄肆蕼
㤅	㤅
㥯	㒚㡥㥯㶏䌥䭡嶾懚檼櫽瘾癮稳穩隐隱
㦰	㦰
㩊	㩊
㫃	㫃
㫐	㞁㫐䆞梎窅
㬎	㙷㬎㬤䏉䜙儑显湿溼漯濕礘隰韅顯
㱚	㱚
㱿	㜌㝅㱿㲄㲉㷤䍍䐨嗀壳彀悫愨榖殼毂瀔瑴瞉穀糓縠螜觳豰轂鷇
㳄	㳄䢭羡羨
㶣	㶣覝
㸒	㸒婬淫霪
㸚	㸚
㹜	㹜
㼌	㼌窳
㿟	㿟
䀠	㪺䀠
䍃	䁘䍃䔄䚻䠛傜嗂媱徭愮搖摇榣猺瑤瑶窰謠謡谣遙遥鎐颻飖鰩鳐鷂鹞
䏌	䏌佾洕
䖒	㚀㺣䖒嚱巇戏戲隵
䖜	䖜
䙴	䉦䙴僊櫏跹蹮躚遷韆
䚘	䚘
䜌	㝈㪻㱍䘎䜌变圝娈孌孪孿峦巒弯彎恋戀挛攣曫栾欒湾滦灓灣灤矕羉脔臠蛮蠻變銮鑾鸞鸾
䡓	䡓
䧹	䧹噟应應膺譍鷹鹰
䨳	䨳
䨿	㒎㗺㩑㪪䙣䨿䪞
䩗	䩗
䩶	䩶
䭆	䭆
䭴	䭴
䲜	䲜
䵞	䵞
一	一弌
丁	㼗䆑䟓䦺丁仃叮圢奵庁忊打朾汀玎町疔盯矴耵艼虰訂订酊釘钉靪頂顶飣饤
丂	㤍㱙㽲䲾丂巧攷朽
七	㲺七叱柒齔龀
万	万
丈	㽴丈仗杖
三	三弎
上	丄上
下	丅下芐
不	不抔杯盃紑罘肧芣衃鴀
与	与
丏	㴐丏汅沔眄麪
丐	丐匃匄鈣钙
丑	䂇䏔䖡丑妞峱忸扭杻沑狃粈紐纽羞莥衄鈕钮
且	㚗㡹䃊䏣䔃䢐䢸且伹俎刞咀坥姐岨徂怚抯柤殂沮狙珇疽砠祖租笡粗組组罝苴菹葅蒩蛆袓觕詛诅豠趄跙鉏阻雎靻飷駔驵麆齟龃
丕	㔻䪹䲹丕伾呸坯岯怌秠胚豾邳鉟駓髬魾
世	㔺㰥世丗勩卋呭屉屜抴枻泄疶紲绁袣詍貰贳跇迣靾齛
丘	丘丠蚯邱
丙	丙寎怲昞昺柄炳病窉苪蛃邴鈵
並	䰃並湴碰竝踫
丨	丨
丩	㽱䡂丩叫嘂朻糾纠芁虬虯觓訆赳鼼
个	个
丫	丫
中	中仲冲忠忡沖浺盅种翀衷
丮	丮谻
丯	丯
丰	㭋丰仹妦玤肨蚌
丱	丱卝
串	䍺串患槵漶贃
丸	㿪䀓䴟丸汍紈纨肒芄骫
丹	丹坍旃栴鴅
主	㹥䪒丶主住妵宔嵀拄柱注炷疰罜蘣蛀註跓軴鉒霔飳駐驻麈黈
丽	丽
丿	丿
乀	乀
乂	㣻㲼䖊䢃乂刈
乃	乃仍奶扔氖疓礽艿芿辸鼐
久	㝌久柩灸玖畂疚
乇	㓃㡯㤞䅊䒲䖳乇仛侂侘厇吒咤奼姹宅托杔灹矺秅秺虴託詫诧飥饦馲魠
之	之妛旹芝
乍	㸲䋏䩆乍作做厏咋岝怍拃搾昨柞榨泎炸痄砟祚秨窄笮筰胙舴莋葃蚱詐诈迮酢醡鈼阼飵鮓鲊齚
乎	㭔乎呼苸軤
乏	㞏䍇䒦乏姂柉泛眨砭窆覂貶贬鴔
乑	㐺乑
乖	㔞㾩䓙乖
乘	乗乘剩剰塖嵊椉溗騬
乙	䰲䵝乙劜圠挖穵肊軋轧鳦
乚	乚
九	㘲㙀㭝䊵䜪九仇勼匦匭厹叴宄尻扏旭朹氿泦犰猇究肍艽虓訄訅軌轨釚頄馗鳩鸠鼽
乞	㩿䒗䞘䦍䩐䰴乞仡吃圪屹忔扢汔疙盵矻籺紇纥訖讫迄釳麧齕龁
也	䄬䪧䶔也他匜地弛忚扡杝池灺牠肔虵衪貤迆酏阤馳驰髢
乳	㳶乳啂
亂	乱亂薍覶覼
了	䑠了釕钌
予	予伃墅壄妤序忬抒杼滪澦紓纾舒芧蕷豫野預预
事	事倳剚
二	二弍樲腻膩貳贰
于	㝼㽳䢓䣿䩒䵦于冔吁宇扜旴杅汙玗盂盓盱竽紆纡芋虶訏迂邘釪骬
亏	亏圬扝杇汚污虧釫
云	䉙䢵䰟䲰云囩夽妘忶抎橒沄澐紜纭耘耺芸蕓雲魂
互	䇘互冱枑沍魱
五	五伍
井	丼井妌汫穽耕阱
亖	亖
亘	䚙亘咺垣峘恒暅桓洹烜狟絙荁貆
亙	䱎亙堩恆揯搄縆
亞	㝞㰳䃁䛩䜑䢝亚亞俹哑啞噁垩堊娅婭恶惡桠椏瘂稏蝁錏铔鵶
亟	㥛䩯亟極殛
亡	㟐㠵䥰亡吂妄忘忙恾朚望杗氓汒甿盲硭肓芒茫莣虻蝱衁邙鋩铓
亢	㰠㽘䟘䡉䴚亢伉劥吭坑忼抗杭沆炕牨犺砊秔笐肮航苀蚢迒邟閌闶阬頏颃骯魧
交	㬵㼎䂭䉰䍊䕧䘨䢒交佼傚効咬姣恔效晈校洨烄狡珓皎礮窔筊絞绞胶茭蛟詨跤較较郊鉸铰頝餃饺駮骹鮫鲛鵁齩
亥	㚊㤥㧡㱾䬵亥侅刻劾咳垓奒姟孩峐晐核欬氦烗痎硋絯胲荄該该豥賅赅輆郂閡阂陔頦颏餩駭骇骸
亦	㴒亦奕帟弈
亨	亨哼悙烹脝
享	享亯
京	㹁䁁䝶䣼京亮倞凉剠勍弶掠椋涼綡諒谅輬鯨鲸鶁麖黥
亭	䁎亭停婷揨楟渟聤葶
亳	亳
亶	㔊㣶䁴䄠䆄䡀亶儃坛壇嬗擅旜檀毡氈澶皽繵羶膻蟺襢譠邅顫颤饘驙鱣鳣鸇鹯
人	人仁佞朲
亼	亼
今	㪁䔷䩂䪩䰼䶃䶖今吟坅妗庈搇枔欦玪琴笒紟耹肣芩荶衾衿訡鈐钤雂靲鳹黅黔
介	㝏㠹䦏䯰䲸介价圿妎尬忦扴玠界疥砎芥衸骱魪齘
仌	㵗仌冫冯冰凭憑砯馮
从	从
付	㾈䒀䠵付咐坿姇弣怤拊柎泭祔符紨胕苻蚹袝跗軵鉜附駙驸鮒鲋
仙	仙仚苮
仝	仝
代	代岱帒玳袋貸贷鴏黛
令	㸳䉁䕘䯍䴇令伶冷刢呤命囹姈岭嶺彾怜拎旍昤柃泠澪狑玲瓴矜砱秢竛笭紷羚翎聆舲苓蕶蛉袊詅跉軨鈴铃閝阾零領领駖魿鴒鸰鹷齡龄
件	件
任	䇮䛘䣸任恁拰栠絍荏袵賃赁銋餁鵀
企	企
伊	伊咿蛜
伏	伏垘栿洑絥茯袱
伐	䣹伐垡栰筏茷閥阀
休	㹯㾋休咻庥恘烋茠貅髤髹鵂鸺
位	位涖莅蒞
余	㻌䅷䍱䔑䞮䣄䩣佘余俆叙塗峹嵞庩徐悆悇捈搽敘斜梌涂漵狳瑹畬畲稌筡艅茶荼蒤蜍賒赊途酴雓餘駼鵌
佩	佩珮
侃	侃偘諐
來	㾢䅘䋱䚅來倈勑唻崃崍庲徕徠来棶涞淶猍睐睞莱萊誺賚赉逨郲騋鯠鶆麳
侌	侌廕荫蔭阴陰霠
侖	䈁䑳仑伦侖倫崘崙惀抡掄棆沦淪溣睔碖綸纶耣菕蜦論论踚輪轮錀陯鯩
侯	㮢䗔䙈䞀䫛侯候喉堠帿猴瘊睺矦篌糇緱缑翭葔鄇鍭餱鯸
侵	㾛䈜䜷䯹侵埐寑寖寝寢梫浸濅祲綅薓鋟锓駸骎
便	㛹便楩箯緶缏鞭鯾
保	㨐保堡堢宲緥葆裒褒褓襃賲
俞	㓱㡏㢏㼶䕆䜽䠼䤅䩱俞偷喻堬媮崳愈愉揄榆歈毹渝牏瑜瘉癒窬緰羭腧萮蕍蝓褕覦觎諭谕貐踰輸输逾鄃鍮隃騟
信	信
倉	仓伧倉傖凔创創呛嗆怆愴抢搶枪槍沧滄牄玱瑲疮瘡舱艙苍蒼跄蹌鎗鶬
倝	㲦䮧乾倝幹擀斡榦漧澣瀚簳翰螒雗韓韩鶾
傘	伞傘
備	㣁㸢俻備备惫憊犕糒鞴韛
傝	䈳䪚傝塌搨榻毾溻蹋躢遢闒阘鰨
僉	㿌䌞䲓佥俭僉儉剑劍劒劔匳厱噞奁奩嬐崄嶮憸捡撿敛斂检檢歛殓殮潋瀲猃獫睑瞼碱簽籢籨羷脸臉蔹薟蘞譣醶险險顩驗验鹼
僰	僰
儥	䢱儥匵嬻椟櫝殰渎瀆牍牘犊犢瓄皾窦竇續续藚襩覿觌讀讟读豄贕贖赎韇黩黷
兀	䑢兀屼扤杌矹軏髡鼿
允	允吮抁沇狁玧馻
兂	兂
元	䬧䯈元冠刓园妧岏忨抏杬沅玩翫芫蚖貦邧阮頑顽黿鼋
兄	兄况怳況貺贶
充	㤝㳘䘪充珫統统茺銃铳
兆	䂪䄻䍮䠷佻兆咷垗姚庣恌挑旐晁朓桃洮烑狣珧眺祧窕筄絩聎脁艞覜誂趒跳逃銚铫鞉頫餆駣鮡鼗
先	㪇㭠侁先兟冼姺毨洗筅箲詵诜跣銑铣駪
光	䯑侊光垙恍桄洸灮胱茪觥輄駫
克	克剋勀勊
兌	㟋䌼䓲䫄䬽侻兌兑娧帨悅悦挩捝敓敚梲棁毤涗涚痥稅税綐脫脱莌蛻蜕裞說説说銳鋭锐閱閲阅駾鮵
免	㝃俛免冕勉奿娩婏嬎悗挽晚浼絻脕莬輓鞔鮸
兒	㪒䍲䘽倪儿兒唲堄婗掜晲棿猊睨蜺觬誽貎輗郳陧隉霓鯢鲵鶂麑齯
兓	兓灊鬵
兔	㭸㲋䖘兔梚菟鵵
兕	兕
兗	兖兗渷萒
兜	兜篼
兢	兢殑
入	入
內	㕯㘨㨅㨥㶧䄲䪏內内吶呐妠抐枘汭焫笍納纳肭芮蒳蜹衲訥讷豽軜鈉钠魶
全	㒰䀬佺全峑恮拴栓牷痊硂筌絟荃詮诠跧輇辁醛銓铨駩
兩	㒳㔝两俩倆兩緉脼蜽輛辆魉魎
八	八叭扒朳汃玐趴釟
公	㕬䇗䡆䯳伀公妐彸忪炂瓮蚣衳訟讼頌颂
六	六
兮	䒊䚷兮枍盻
共	㤨䢼䧆䱋䳍供共哄巷恭拱拲栱洪港烘珙舼葓蕻蛬衖谼輁輂鉷髸鬨龏龔龚
兵	㑟㙃兵捠浜
其	䑴䫏䳢䶞僛其唭基娸帺惎旗朞期棊棋櫀欺淇琪璂碁祺禥稘箕綦綨萁藄蜝蜞諅諆踑錤騏骐魌鯕麒
具	㮂䋰䡞俱具埧椇颶飓
典	㥏䠄典晪淟琠痶碘腆賟錪
兹	兹嗞孳嵫慈滋濨磁礠稵糍茲螆鎡镃鰦鶿鷀鹚
兼	㡘㺌㽐㾾䫡䭑傔兼嗛嫌尲嵰慊搛槏歉溓熑甉稴縑缣膁蒹謙谦豏賺赚鎌隒馦鬑鰜鳒鶼鹣鹻鼸
冀	兾冀懻驥骥
冂	冂
冃	冃
冉	㘱㴂㾆䎃䔜䶲冄冉呥姌抩柟聃舑苒蚺袡髯
冊	冊册柵栅笧
冋	冋坰扃泂炯絅苘詗迥駉
再	再洅
冎	冎
冏	㴄冏囧
冒	冒勖勗媢帽瑁艒萺賵赗
冓	㗕㝤䃓傋冓媾搆斠构構沟溝煹篝耩褠覯觏講讲購购遘鞲韝
冖	冖冟鼏
冗	䢇冗宂
冘	㓄㱽㼉㽎㽸䏙䒞䪴冘妉忱抌枕沈沉瓭眈紞耽莐衴訦邥酖鈂霃馾髧魫鴆鸩黕
冡	䴿冡霥
冤	䥉冤蒬
冥	㨠䈿䏃䒌䫤冥塓嫇幎慏暝榠溟猽瞑蓂螟覭鄍
冬	㠽㤏䈺䶱佟冬咚柊泈炵疼笗終终苳蔠螽鉖鴤鼕鼨
几	㞦䢳几机肌虮飢饥麂
凡	凡凤帆梵汎芃軓釩钒鳳
凵	㧄凵
凶	㟅兇凶匈忷恟汹洶胷胸訩詾酗
凷	凷屆届
出	㑁㒴㤕㽾䂐䖦䪼出咄拙柮欪泏炪窋絀绌聉胐茁袦詘诎貀趉鈯黜齣
函	㮭䈄䤴䨡函圅涵菡蜬顄
刀	䫸刀叨忉朷灱舠芀釗钊魛鱽鳭
刁	刁叼
刃	㠴㲽䏰䵑仞刃忍杒涊牣紉纫肕荵訒認认軔轫韌韧
刅	刅刱梁粱
分	㞣份分吩坋坌妢弅忿扮攽朌枌梤棻棼氛汾玢盼砏秎粉紛纷羒肦芬蚡衯貧贫邠雰頒颁馚魵鳻黺鼢
切	䀙䟙切沏砌
刑	㓝㼛侀刑型形硎荆荊邢鈃鉶钘铏
列	㤠㾐䅀䶛例冽列咧姴峛挒栵洌烈茢蛚裂迾銐颲鮤鴷
初	初
別	㭭䇷䤢別别哵捌莂
利	䬆䴻俐利梨棃浰犁犂琍瓈痢筣莉蔾藜蜊蟍邌鑗鯬鵹黎黧
刪	䈀删刪姍姗狦珊跚
到	倒到捯菿
制	䎺䱥制掣淛猘痸製
則	侧側则則厕崱廁恻惻测測萴鍘铡鰂鲗
剌	㻝䓶剌喇揧楋瘌蝲辢辣鵣
前	㨵㮍前剪媊揃湔煎箭翦葥譾谫騚鬋
剝	䃗剝剥
劉	䉧䬟刘劉嬼懰浏瀏
力	㔹仂力勒叻嘞屴扐朸泐玏竻肋艻阞鳨
加	㤎㵑䴥伽加咖嘉妿架枷珈痂瘸笳茄袈賀贺跏迦駕驾鴐
劣	劣
劦	劦勰协協叶姭拹栛珕荔
助	助筯耡鋤锄
勞	䃕䝁僗劳勞唠嘮憥捞撈涝澇犖痨癆簩膋荦蟧髝
勺	㣿䄪䋤䶂仢勺妁尥彴扚杓汋灼犳玓瓝瘹的礿肑芍豹趵酌釣钓靮馰魡
勿	㫚䀛伆刎勿匫吻岉昒曶沕物笏脗芴
匀	勻匀呁均憌昀枃汮畇盷笉筠荺袀赹鈞钧韵
包	㯡䍖䎂䛌䮀刨勹勽包匏咆庖抱枹泡炮炰狍玸瓟疱皰砲窇胞苞菢袌袍跑軳辔鉋雹靤鞄颮飑飽饱骲鮑鲍
匊	㥌㹼㽤䗇䜯䱡匊巈掬椈毱菊蘜諊趜踘鞠鞫驧鵴麴
匋	䛬匋啕掏淘祹綯萄蜪裪陶騊
匕	匕庀朼牝疕
化	㗾化吪囮杹花訛讹貨货鈋靴魤
北	北苝邶
匘	㛴㺁匘堖恼惱瑙硇碯脑腦
匠	䞪匠
匡	䒰䖱劻匡匩哐恇框洭眶筐誆诓軭邼
匸	匸
匹	䏘匹鴄
医	医
匽	㰽䞁偃匽堰揠蝘褗躽郾鰋鶠鼴鼹
匿	㥾䘌匿慝暱
區	䙔䧢䩽伛傴剾区區呕嘔塸妪嫗岖嶇彄抠摳敺枢樞櫙欧歐殴毆沤漚瓯甌瞘膒蓲謳讴貙躯軀醧鏂饇驅驱鰸鷗鸥
十	什十卙汁計计針针
卂	卂扟汛籸虱蝨訊訙讯軐迅阠
千	仟千圱杄汘芊谸迁阡
卅	卅
升	升抍昇陞
午	仵午忤旿杵汻浒滸許许迕
卉	卉泋芔
半	㪵䉽䬳伴冸判半叛坢姅拌柈泮牉畔絆绊胖袢靽頖
卌	卌
卑	㗗㪏㯅㵺㼰䇑䚜䫌䱝䴽俾卑啤埤婢崥庳捭椑渒焷牌猈琕痺睥碑稗箄粺綼脾萆蜱螷蠯裨諀豍郫錍陴鞞髀鵯鹎鼙
卒	㰵㱖㲞䚝䱣倅卒啐崒崪悴捽晬椊淬焠猝瘁睟碎祽稡窣粹綷萃誶谇賥踤醉錊顇
卓	㷹䂽䈇倬卓啅婥悼掉晫桌棹淖焯綽繛绰罩趠踔逴鋽鵫
南	䈒䋻南喃揇楠湳罱腩萳諵
卜	㺪䟔仆卜圤扑攴朴訃讣赴鳪
卞	卞忭抃汴犿苄飰
卟	乩卟
占	㓠㚲㥈㼭䀡䍄䩇䩞䬯佔占呫坫帖店怗惦扂拈掂敁枮檆沾炶点煔玷痁砧站笘粘苫蛅覘觇詀貼贴跕踮鉆阽霑頕颭飐鮎鲇黇黏點
卣	卣
卩	卩卪
卬	㭿䒢䩕䭹仰卬昂枊迎
卯	㗦䱖丣卯奅戼昴柳泖珋窌聊茆貿贸鄮駠
印	印抑鮣
危	㩻䣀䤥佹危卼垝姽尯峗峞恑桅洈硊祪蛫觤詭诡跪陒頠鮠
即	䐚即卽唧堲揤楖蝍鯽鲫
卵	㤻卵
卷	㒽䅚䊎倦卷圈埢婘捲棬淃犈睠綣绻腃菤蔨蜷裷踡鬈
卸	卸啣
卻	却卻脚腳
卿	卿
厂	㷳厂屵贋贗赝雁鳫鴈
厃	厃
厄	㧖厄呃呝戹扼蚅豟軛軶轭阨阸
厓	厓啀娾崖捱涯睚
厚	厚
原	㹉傆原厵嫄愿榞源獂縓羱蒝謜豲願騵
厤	㽁历厤曆磿
厥	㵐劂厥憠撅橛橜獗蕨蟨蟩蹶蹷鱖鳜鷢
厭	压厌厣厭厴壓嬮懕擪檿靥靨餍饜魇魘黡黶
厲	励勵厉厲巁櫔濿犡砺礪禲粝糲蛎蠣
厶	㺨厶私
厷	䍔厷吰宏浤竑紘纮翃耾肱谹鈜閎闳雄
厸	厸
去	㧁㭕㰦䒧佉去呿弆抾祛胠袪阹魼麮鼁
厽	厽垒絫
叀	叀
參	㜗㧲㺑㽩䊉䟃䫅䫩俕傪参參墋嵾惨慘掺摻曑槮毵毿渗滲犙瘮碜磣穇篸糁糝縿蔘謲遪醦驂骖鬖黲
又	㕛又友
叉	㳗䑡䟕叉扠杈汊芆衩訍釵钗靫
及	㚫㠷㧀㽺䑥䲯伋及吸圾岌彶急扱昅极汲砐笈級级芨衱趿鈒雭靸馺魥
反	㤆㽹䡊反坂扳昄板汳版瓪畈眅粄舨蝂販贩返鈑钣阪飯饭魬
叔	俶叔埱婌惄掓敊淑琡督菽蔋裻錖
叕	㱀䄌䞵䟾䫎剟叕啜娺惙掇敠欼歠畷窡綴缀罬腏蝃裰輟辍逫醊錣餟鵽
取	㖩㷅䕺丛取叢埾娵娶掫棷棸箃緅菆諏诹趣郰陬鯫鲰黀齱
受	㖟受授綬绶
叚	䠍䫗假叚嘏婽暇椵煆犌猳瑕瘕碬葭蕸虾蝦豭貑赮遐鍜霞騢鰕麚
叟	㛐㛮㪢㮴㵻䏂䕅䩳䬒傁叜叟嫂廋搜溲獀瘦瞍艘螋謏遚鄋醙鎪锼颼飕餿馊騪
口	口叩扣筘釦
古	㕆㱠㼋㽽䊀䔯估古咕姑岵怙故枯楛沽牯瓳盬祜罟苦蛄詁诂跍軲酤鈷钴骷鴣鸪
句	䅓䈮䑦䝭䞤䧁䪷佝劬勾句呴喣够夠姁岣怐拘敂斪昫朐枸欨煦狗玽痀眗竘笱絇翑耇胊苟葋蒟蚼訽豞豿跔軥邭鉤钩雊駒驹鮈鴝鸲鼩齁
叧	叧拐枴柺箉
只	㰨䳅伿只咫抧枳疻胑軹轵齞
召	㲈㸛䂏䈃䎄䙼䫿䬰佋劭卲召岧弨怊招昭柖欩沼炤照玿眧紹綤绍苕菬蛁袑詔诏貂超軺轺迢邵鉊鞀韶髫
可	㗿㪃㫊㰤㱒䯊䶗何可呵哿坷妸岢抲柯河渮牁珂疴砢笴舸苛荷菏蚵袔訶诃跒軻轲鈳钶閜魺鴚
台	㾂䈚佁冶台咍始孡怠怡抬枲殆治炱珆瓵眙笞紿绐胎苔菭詒诒貽贻跆軩辝迨邰鈶颱飴饴駘骀鮐鲐齝
史	史駛驶
右	佑右祐醢
号	㙱号呺枵號饕鴞鸮
司	伺司呞嗣孠柌祠笥覗詞词飼饲
各	㓢㗉㤩㦴䀩䂮䅂䌎䛚䞦䶅佫各咯垎峉恪挌搁擱敋格洛烙狢珞略硌笿簵絡络胳茖落蛒袼觡詻貉賂赂輅辂酪鉻铬閣阁雒頟駱骆骼鮥鵅
吅	吅
合	㓣㢵㭘㾑㿯䀫䆟䞩䢔䨐䶀䶎佮匌合哈姶帢恰拾敆欱洽湁烚珨畣盒祫給给耠蛤袷詥跲郃鉿铪閤鞈韐頜颌餄鮯鴿鸽龕龛
吉	㓤㣟䂒䕸䦖佶劼吉咭夡姞恄拮撷擷桔欯洁狤硈秸結纈结缬翓聐蛣袺襭詰诘趌郆頡颉髻鮚鲒鴶黠
同	㓊㢥䆚侗同哃姛峒恫戙挏桐洞烔痌眮硐筒絧胴衕詷迵酮銅铜駧鮦鲖
名	名姳洺眳茗詺酩銘铭
后	㖃㸸䞧后垕垢姤缿茩詬诟逅郈銗骺鮜鲘
吏	使吏
向	䖮向嚮晌珦餉饷
君	㴫䇹僒君宭峮帬捃桾涒焄窘羣群莙裙裠輑郡頵鮶麏
吝	吝悋麐
吠	吠鼣
否	䓏䫠俖否嚭娝桮痞
含	㟏含唅梒浛琀筨莟谽鋡頷颔馠
吳	㻍俁俣吳吴噳娛娱悞澞祦虞蜈誤误鋘鸆麌
吹	䶴吹炊焁
吾	㹳䎸䓊吾唔啎圄娪寤峿悟捂敔晤梧浯珸窹衙語语逜郚鋙铻鯃鼯齬龉
呂	侣侶吕呂梠筥絽莒郘鋁铝
呈	䇸呈塣徎悜挰桯浧珵睈程裎逞郢酲鋥鞓
告	䧊䧼䶜吿告喾嚳晧梏浩焅牿皓硞祰窖簉誥诰郜酷靠頶鵠鹄
周	㚋䞴䯾倜凋周啁奝婤彫惆晭椆琱碉禂稠綢绸翢蜩裯調调賙赒輖週郮錭雕鯛鲷鵰
咅	㯁㰴㾦䋨䍌䎧䏽䞳䯽䳝䴺倍剖咅培婄掊棓殕毰涪焙犃瓿箁篰菩蓓蔀賠赔踣部醅陪
咎	㰶㹾䓘䛮倃厬咎晷櫜綹绺麔鼛
咠	䁒咠戢揖楫檝湒濈箿緝缉葺蕺諿輯辑霵
咢	㖾㗁㮙偔咢堮崿愕湂腭萼諤谔遌遻鄂鍔锷顎颚鰐鶚鹗齶
咶	䀨䄆䒷䟯䯏佸刮咶姡憩懖括敌活秳筈聒萿葀蛞話话趏适闊阔頢颳髺鴰鸹
咸	㰹㺂䁍䌠䶢减咸喊椷減瑊箴緘缄羬葴諴輱醎鍼顑鱵鹹麙黬
咼	㗻䈑䯞剐剮咼喎埚堝娲媧楇檛歄涡渦濄瘑碢祸禍窝窩簻緺脶腡膼莴萵薖蜗蝸諣过過鍋鐹锅騧
哀	偯哀
品	品闆
哉	䛋䵧哉栽渽溨烖睵胾蛓裁載载酨
員	䐣䚋䫟勋勛员員圆圓塤愪损損殒殞溳磒筼篔縜貟郧鄖陨隕霣韻
哥	哥歌滒謌
哭	哭
唐	㲥㼺䧜傏唐塘嵣搪榶溏煻瑭磄篖糖蓎螗赯醣鎕餹鶶
唯	䗽倠唯婎帷惟潍濉濰猚琟睢維维蓶虽蜼踓雖鷕
商	商蔏螪
啇	㹍䊞䎮䵂啇啻嘀嫡摘擿敵樀滴甋膪謫讁谪蹢適鏑镝
啓	䁈䏿启啓啟晵棨綮闙
啚	啚鄙
善	僐善墡嫸橏磰繕缮膳蟮譱鄯饍鱔鳝
喜	㰻䵱僖喜嘻嬉憙歖熹瞦禧糦蟢譆饎
喦	喦
喪	丧喪
喬	㝯㢗䀉䎗䚩乔侨僑喬嘺娇嬌屩峤嶠憍挢撟敽桥橋毊獢矫矯穚簥繑荞蕎蟜譑趫蹻轎轿鐈鞽驕骄鱎鷮
單	㠆㺗䐷䡲䯬䵐亸僤匰单啴單嘽嚲墠婵嬋幝弹彈惮憚战戰掸撣樿殚殫潬灛燀瘅癉磾禅禪箪簞繟蕇蝉蟬襌觯觶貚郸鄲闡阐驒鱓鷤鼉鼍
喿	㿋劋喿噪幧懆操橾澡燥璪繰缲臊藻譟趮躁鄵鐰髞鱢
嗇	㱇䉢啬嗇懎濇穑穡繬轖
嘆	㔮䎯叹嘆擹暵歎汉漢熯
器	器
噩	噩鑩鱷鳄
嚴	㘙䉷严俨儼嚴岩巖曮玁礹讝酽釅
囂	㺧䖀嚣囂虈
囗	囗
囚	囚泅苬鮂
四	呬四柶泗牭訵駟驷
回	䛛佪回徊洄茴蛔迴
囟	囟細细顖
因	㘻㧢㸶咽因姻欭氤洇烟絪胭茵裀鞇駰骃
囪	匆囪囱窗
困	困悃捆梱涃睏硱稇綑裍閫阃齫
囷	㖥㻒䐃囷攈稛箘菌蜠麇麕
固	䍛個凅固婟棝涸痼稒箇錮锢鯝
圂	㨡㮯圂慁溷
圉	圉
國	嘓国國帼幗慖掴摑漍簂膕蔮蝈蟈
圖	图圖
土	䀅吐土徒杜社肚芏荰靯
圣	圣怪恠
圥	圥
在	在茬
圭	㜇㥨㨒㰪㾏䖯䙵䞨䠑䯓䳏佳刲卦哇圭奊奎娃恚挂掛桂楏洼溎烓珪畦眭睳硅窐窪筀絓罣胿茥蘳蛙蝰街袿褂觟詿诖跬邽閨闺鞋鮭鲑黊鼃
圼	㖏㘿圼捏涅篞
坐	㛗䂳侳剉坐夎座挫痤睉矬脞莝趖遳銼锉髽
坒	㙄䯗坒悂梐狴陛
坤	坤
坴	䡜坴淕睦稑踛逵陆陸鯥鵱
垂	㩾䅜䮔倕厜唾垂埵娷捶涶甀睡硾箠綞缍腄菙諈錘锤陲
垔	㢾䚈垔堙歅湮煙甄禋籈薽諲鄄闉陻黫
垖	䏨垖桘頧鴭
垚	垚
埶	亵势勢呓囈埶暬槷槸热熱爇艺蓺藝褹褻
執	㝪䠟䲀垫執墊慹执挚摯漐瓡絷縶蓻蛰蟄褺謺贄贽騺鷙鸷
堂	䣘坣堂樘瞠糛膛螳鏜镗闛隚鼞
堇	㝻㨷㹏仅僅勤囏堇墐廑慬懃懄槿歏殣漌瑾瘽螼覲觐謹谨鄞饉馑
堯	㚁䁱䥵䴃侥僥哓嘵堯墝娆嬈尧峣嶢憢挠撓晓曉桡橈浇澆烧燒獟皢硗磽穘繞绕翘翹膮荛蕘蛲蟯襓譊趬跷蹺遶鐃铙顤饒饶驍
報	報报
塞	㥶僿塞寨簺賽赛
塵	塵尘
士	仕士茌
壬	䏕壬妊紝纴衽飪饪
壯	䊋匨壮壯奘庄莊装裝
壴	壴
壹	㙪䊦亄噎壹懿撎曀殪豷饐鷧
壺	㯛壶壷壺
壼	壸壼
壽	㹗㿒䊭䬞䮻俦儔壔壽寿帱幬懤擣梼檮涛濤焘燽燾璹畴疇祷禱筹籌翿薵譸诪踌躊醻鑄铸魗
夂	夂
夃	夃羖股
夅	䂫䇨䜶夅栙洚絳绛跭降
夆	㸼夆峯峰捀桻烽胮舽莑蜂鋒锋韸髼
夊	䒘夊
夋	㕙䈗䘒䝜䞭俊唆埈夋峻悛捘晙朘梭浚焌狻畯痠皴稄竣脧荾葰誜踆逡酸鋑陖餕駿骏鵕
夌	㥄㱥䔖倰凌夌崚庱掕棱淩睖祾稜綾绫菱蔆踜輘陵鯪鲮
复	㙏复復愎椱澓腹蕧蝮複覆輹鍑馥鰒鳆
夏	厦嗄夏廈榎
夐	夐敻琼瓊矎藑觼讂
夒	㹛巎扰擾獿
夔	夔犪躨
夕	夕汐矽穸
夗	㠾䖤䛄夗怨盌眢苑葾鴛鸳
夙	㑉夙洬
多	㒅㗬㡅㢁㢋㶴䋾䏧䐒䔟䡔䫂䬷侈卶哆垑多奓姼恀扅拸栘橠熪爹痑眵移簃蛥袲袳誃謻趍跢迻鉹陊黟
夜	䘸䤳夜掖液焲腋鵺
大	㐲䲦大太忕戻杕汏汰泰軑达釱馱驮
夨	㳁仄夨庂昃
天	䚶吞天祆
夫	㠸䃿䄮伕夫妋扶枎玞肤芙蚨衭趺邞鈇颫鳺麩麸
夬	㭈䀗䆕䆢䏐䦑决吷夬妜快抉決炔玦疦筷缺芵蒛蚗袂觖訣诀赽趹鈌駃鴂
夭	㕭㤇䴠仸夭妖枖殀沃祅芺訞鋈镺飫饫
央	㹧㿮䄃䇦䬬佒咉坱央姎岟怏映柍殃泱炴盎眏秧紻胦詇軮醠鉠雵鞅駚鴦鸯
夰	夰奡昊昦
失	䭿䰡䳀佚劮失妷帙抶昳柣泆瓞眣秩紩翐胅苵蛈袠詄趃跌軼轶迭镻
夲	夲
夵	夵
夷	䧅䨑咦夷姨峓恞桋洟痍眱羠胰荑蛦跠銕鮧鴺
夸	㡁㰭䠸侉刳咵垮夸姱恗挎摦洿瓠絝胯荂袴誇跨郀銙陓骻鮬鴮
夾	㛍㤲㥦㥷㰰㰼㼪㾜㿓䀹䇲䧪䩡䬊䵌侠俠匧唊夹夾峡峽悏惬愜挟挾梜浃浹狭狹瘗瘞瘱硖硤筴箧篋綊翜脥荚莢蛱蛺裌郏郟鋏铗陜陿頰颊鵊
奄	㛪㞄㡋㤿㪑㭺䁆䎨䛳䣍䤶俺唵埯奄崦庵掩晻殗淹罨腌菴裺醃閹阉餣馣鵪鹌黤
奇	㞆㢊㥓㱦㾨䐀䗁倚剞奇婍寄崎徛掎攲旖椅檹欹漪犄猗琦畸碕竒綺绮觭踦躸輢錡锜陭騎骑鵸齮
奉	俸唪埲奉捧棒琫菶蜯
奏	凑奏揍楱湊腠輳辏
奐	唤喚奂奐寏换換涣渙焕煥痪瘓
奔	奔錛锛餴鼖
奚	㜎㨙䙎傒奚嵠徯慀榽溪磎膎蒵螇謑谿豯貕蹊雞鞵騱鷄鸂鸡鼷
奠	㞟㽀奠掷擲踯躑郑鄭
奤	奤
奧	䉛䐿䜒噢墺奥奧懊澳燠薁袄襖隩
奪	夺奪
奭	奭襫
奮	奋奮
奰	奰贔赑
女	㚢女汝籹肗
奴	䋈努呶奴孥帑弩怒怓拏拿砮笯詉駑驽
奻	奻
好	好薅
如	如帤恕挐洳絮茹蒘蕠袽鴽
妟	妟宴
妥	㞂㟎㱣㼏䅑妥娞挼桵浽綏绥脮荽鋖餒馁骽鮾鵎
妻	㼮䃀凄妻悽棲淒緀萋郪霋鶈
妾	䈉妾帹接椄淁翣菨踥霎鯜
委	㞜㢻㮃䅗䍴䬐䴧倭委捼涹痿矮緌萎蜲覣諉诿踒躷逶餧
姥	姥峔
姦	姦葌
威	威崴楲葳蝛隇鰄
婁	㜢㪹㺏䅹䝏䣚䱾偻僂喽嘍塿娄婁屡屢屦屨嵝嶁廔慺搂摟楼樓氀溇漊甊瘘瘻瞜窭窶篓簍縷缕耧耬膢艛蒌蔞蝼螻褛褸謱貗遱鏤镂鞻髅髏鷜
婦	妇婦
嬰	䙬嘤嚶婴嬰巊廮撄攖樱櫻瀴璎瓔瘿癭纓缨蘡鸚鹦
嬲	嫐嬲
嬴	㜲䕦嬴攍瀛籝贏赢
嬽	嬽
子	㜽仔子孖孜杍秄籽耔芓虸
孑	孑釨
孓	孒孓
孔	吼孔
孕	孕
字	字牸茡
存	存拵栫洊臶荐袸
孚	㲗䞯䨗䱐䳕俘哹孚孵捊桴殍浮烰琈稃筟粰罦脬艀莩蜉郛
孛	㛘㪍㶿䪬勃哱孛悖挬桲浡渤綍脖荸誖郣餑饽馞鵓鹁
孝	㹲哮孝庨涍窙酵
孟	䁅孟猛艋蜢錳锰
季	季悸痵
孨	孨
孫	孙孫愻搎狲猻荪蓀逊遜
孰	䃞塾孰熟
孱	僝孱樼潺轏
孴	孴
學	㽇䁷䑁䮸学學嶨搅攪斅斆泶澩礐覺觉觷鱟鲎鷽
宀	宀
宁	䍆䘢伫佇宁柠眝竚紵纻羜苎苧詝貯贮
它	㸰㼠䍫䙾䡐䬁佗它拕柁沱紽舵蛇袉詑跎迱酡鉈铊陀駝驼鮀鴕鸵鼧
守	守狩
安	䀂䅁䢿侒咹安按案氨洝胺荌鞌鞍頞鴳
宋	宋
完	䯘䴷俒垸完捖晥梡浣皖睆筦綄脘莞院鯇鲩
宓	䁇宓淧蜜
宕	宕菪
宗	䝋倧孮宗悰棕淙琮粽綜综誴賨踪錝鬃
官	䗆䘾䩪倌婠官悹悺捾棺涫琯痯管綰绾菅輨逭錧館馆
定	定掟淀綻绽錠锭靛顁
宛	䘼䝹䡝䩊䩩倇剜埦婉宛帵惋惌捥晼椀涴焥琬畹睕碗腕菀蜿豌踠鵷鹓黦
宜	㝖宐宜竩誼谊
客	喀客愙揢楁額额髂
宣	䳦喧宣愃揎暄楦渲瑄翧萱蝖諠
室	室
宦	宦
宮	䃔宫宮
宰	䏁䔂宰梓滓縡
害	㪡㮫㲅割害犗瞎磍縖豁轄辖鎋鶷
家	傢嫁家幏稼
宷	㰂婶嬸审宷審瀋
容	㝐㼸䈶傛塎容嵱搈榕溶熔瑢蓉褣鎔镕
宿	䑿宿摍樎縮缩蓿蹜
寅	夤寅戭演濥瞚縯蔩螾鏔
密	㑻密樒滵蔤
寇	寇滱簆蔻
寍	寍
寒	䙭䞿寋寒搴攐藆褰謇蹇鑳騫骞鶱
寡	寡
寣	寣
實	实實
寧	㲰䔭䗿䭢儜咛嚀嬣寗寧拧擰檸泞濘狞獰甯聍聹薴鑏鬡鸋
寸	刌吋寸忖村
寺	侍偫寺峙庤待恃持歭洔畤痔秲詩诗跱邿鼭
寽	㭩㲕㸹䟹哷埒寽捋浖脟蛶酹鋝锊
封	㨍封崶帮幫湗犎葑鞤
尃	㗘䍸䎔䗚䙏䪙䭦䶈傅博尃搏榑欂溥猼礡礴簙簿縛缚膊蒪薄賻赙鎛鑮镈餺馎髆
射	㴬䠶射榭謝谢麝
將	㢡㯍䉃䵼奖将將嶈桨槳浆漿獎蒋蔣螀螿蹡酱醬鏘锵鱂
專	专传傳剸啭囀团團塼嫥專慱抟摶漙甎砖磚竱篿縳膞莼蓴轉转鄟鱄鷒
尉	㷉䲁尉慰熨犚罻蔚螱褽鳚
尊	䔿僔噂墫壿尊嶟撙樽竴繜罇譐蹲遵鐏鱒鳟鷷
尋	寻尋憳撏樳浔潯燖荨蕁襑鄩
尌	厨尌幮廚树樹橱櫥澍蹰躕
對	䨴对對怼懟濧薱轛
小	㭂䒕小釥
尐	尐
少	㠺䒚䖢仯吵妙少抄杪渺炒玅眇秒篎緲缈耖觘訬鈔钞麨
尒	㚷伱你妳尒尔弥您苶迩
尖	尖
尗	䦊寂尗椒茮踧鮛
尚	䉎䟫倘偿償嘗嚐埫嫦尚尝常徜掌撐撑棠橕橖淌牚瓽甞裳賞赏趟蹚躺鋿
尞	㙩䕩䝤䩍僚嘹嫽寮尞嶚憭撩橑潦燎爒獠璙疗療瞭竂簝繚缭膫蟟轑辽遼鐐镣镽飉鷯鹩
尟	尟
尢	尢尣尪
尤	尤忧沋疣肬蚘訧魷鱿
尨	㙙㟌䏵䵨厖哤娏尨浝牻狵痝蛖駹
就	㠇僦噈就殧蹴鷲鹫
尸	㕧䐅尸屍屎屓杘鳲鸤
尹	䪳尹笋芛
尺	呎尺蚇
尼	䝚呢坭埿妮尼屔怩抳旎昵柅泥狔痆秜苨蚭跜迡
尾	䅏䊊䜸䞔䬿娓尾浘
尿	㞙尿
局	䎤侷局挶梮跼鋦駶
居	䝻䱟倨居崌据椐涺琚腒蜛裾踞鋸锯鶋
屈	䓛䘿䞷䠇倔啒堀屈崛掘淈窟鶌
屋	偓剭喔媉屋幄握楃渥腛齷龌
屑	㨝屑榍糏
展	㜊㞡展搌碾輾辗
屖	厗墀屖稚稺謘迟遟遲
屚	屚漏瘺
屠	䠧䣝屠廜鷵
履	履
屬	䌵䙱䠱嘱囑孎属屬斸欘瞩矚蠾钃
屮	屮
屯	㹠䣩吨噸囤坉屯庉忳扽杶沌盹窀純纯肫芚蒓訰豘軘迍邨鈍钝頓顿飩饨黗
屰	屰縌蝷逆
山	䴮山屾汕疝秈籼舢訕讪邖
岑	侺岑梣涔
岡	㓻冈刚剛堈岗岡崗掆犅綱纲鋼钢
岳	岳捳
崇	㓽崇崈漴
崔	䜅催嗺崔嶉嶊慛摧槯漼璀皠繀膗鏙
崩	䣙崩漰繃绷蹦
嵒	嵒癌碞
嵩	嵩
巂	㔒䪎䭨儶孈嶲巂携攜欈瓗纗蠵觽觿讗酅鑴雟驨
巜	巜
川	㸪䡅圳巛川巡紃訓训釧钏順顺馴驯
州	喌州洲詶酬
巟	㡆㬻㼹䀮䐠巟慌荒詤謊谎
巠	䀴䞓䣆䪫俓刭剄劲勁坙娙巠径徑桱氢氫泾涇烃烴牼痉痙硁硜經经羟羥胫脛茎莖葝蛵誙踁輕轻逕鋞鑋陉陘頸颈鵛
巢	㑿䜈䲃剿勦巢摷樔漅璅繅缫罺薻轈鄛
巤	㯿㲱䁽䃳䉭䗶䜲䪉儠巤擸犣獵臈臘蠟躐邋鑞镴鬣鱲
工	㓚䉺䜫䪦䫹仜功叿屸工扛攻杠桏汞江渱澒玒瓨疘矼筇紅红缸羾肛舡茳荭葒虹訌讧豇邛釭項项魟鴻鸿
左	㝾䦈佐左袏
巨	䢹䶙巨拒柜榘歫炬矩秬粔苣螶詎讵距鉅駏
巩	㧬㼦䂬䅃䡗巩恐蛩跫銎鞏
巫	巫莁誣诬鵐
差	㽨㿷䐤䑘䰈䴾傞嗟嵯嵳差搓槎溠瑳瘥磋縒艖蒫褨蹉醝鎈髊鹺鹾齹
己	䋟妀屺己忌改杞梞玘紀纪芑記誋记起跽邔鵋
巳	㱼圯媐已巳巸异戺攺汜熙祀
巴	㿬吧妑巴帊弝把杷爬爸琶疤笆耙舥芭葩蚆豝跁鈀钯靶
巵	㯄卮巵栀梔
巹	巹
巽	㷷䍻䠣僎巽撰潠簨繏蟤襈譔选選鐉顨饌馔
巾	㧆巾
巿	㤄㧊㸬䍨䑔䟛䢌䣪䰽伂巿旆杮沛肺芾霈
帀	䞙匝咂帀沞砸迊韴魳
市	市柿
布	佈布怖抪鈽钸
帇	帇
希	㾙䛥䮎俙唏希悕晞桸欷浠瓻睎稀絺脪莃豨郗鵗
帚	帚箒鯞
帝	㛳䱱偙啼崹帝揥楴渧禘締缔腣蒂諦谛蹄鶙
帥	帅帥
師	师師狮獅筛篩蒒蛳螄鰤
席	席蓆褯
帶	㦅㯂㿃䠠僀墆嵽带帶慸懘摕殢滞滯艜蔕螮蹛遰
幂	冪幂濗羃
干	㔓㢨㿻䍐䮗䵟仠刊奸岸干忓扞旰杆汗涆犴玕皯盰矸秆竿罕肝蓒虷衎衦訐讦豻赶軒轩迀邗酐釬閈闬靬頇顸飦馯骭鳱鼾
平	㛁䍬伻匉坪平怦抨枰泙砰胓苹萍蚲評评閛
年	年秊
幵	㰢㿼䀘䗗䵤䶬妍姸岍幵开揅枅栞汧研笄羿蚈訮詽豜豣趼開雃鳽麉
并	㔙䈂䑫䴵䶄併偋姘屏并庰恲拼摒栟洴瓶皏竮箳簈絣缾胼艵荓蓱蛢賆跰軿迸郱鉼頩餅饼駢骈骿鮩鵧
幸	㼬䛭倖婞幸悻涬緈
幺	吆幺
幻	幻
幼	㑃䬀䱂呦坳幼怮拗泑狕眑窈苭蚴袎軪靿鴢黝
幽	䫜幽
幾	㙨䟇䤒僟叽嘰幾機玑璣畿矶磯禨穖蟣譏讥鐖鞿饑
广	㢂广
庚	庚賡赓鶊
府	俯府腐腑
度	䩲剫喥度渡踱鍍镀
庶	㫂㵂䗪䭖嗻墌庶摭樜蔗蟅謶蹠遮鷓鹧
康	㝩㱂䗧康慷槺漮穅糠躿
庸	㟾㣑㺎䗤傭墉庸慵槦滽鄘鏞镛鱅
廉	䆂嬚帘廉濂濓燫簾薕蠊譧鐮镰
廌	廌
廛	㙻廛瀍緾纏缠躔鄽
廣	嚝圹壙廣彍懬扩擴旷曠櫎瀇爌犷獷矌矿礦穬纊纩邝鄺鑛
延	㢟䀽䘰䩥唌埏延挻梴涎狿硟筵綖脠莚蛋蜑蜒誕诞郔鋋鯅
廷	㹶䩠侹娗庭廷挺梃涏珽筳綎脡艇莛蜓誔鋌铤霆頲颋鼮
建	㯬䭈健建揵旔楗毽湕犍腱鍵键鞬騝
廾	廾
廿	廿
弁	㝸㮥㺹䒪䪻匥弁拚昪畚笲軬閞鴘
弃	弃棄
弄	㢅㳥哢弄梇硦
弇	媕弇揜渰鞥黭
弋	㚤䄩䘝䣧䴬弋忒杙甙芅貣釴隿黓
式	侙式弑弒恜拭栻烒試试軾轼鉽
弓	弓芎
弔	伄吊弔盄
引	䀕䏖引弞矤矧紖蚓訠鈏靷
弗	㔗䄶䛍䞞佛刜咈坲弗彿怫拂昲柫氟沸炥狒疿砩笰紼绋胇艴茀髴
弘	宖弘泓紭苰鞃
弟	㖒䑯䬾剃娣弟悌挮梯涕睇稊第綈绨罤苐蕛豑銻锑鬀鮷鵜鹈
弢	弢詜
弦	㡉婱弦惤
弭	㥝弭渳葞麛
弱	䐞䚥嫋弱愵搦溺篛蒻
强	勥弜強强繈膙襁鏹镪
弼	㢸弼
彑	彐彑
彔	㪖㫽㯟䎑䚄䟿䱚娽彔录氯淥渌琭盝睩碌祿禄箓簶籙綠緑绿菉趢逯醁錄録騄龣
彖	㔏㥟䂕䛹䤙䧘䱲剶劙喙堟墬彖掾椽橼櫞欚湪猭瑑盠篆緣缘蝝蠡褖餯鶨
彗	㨹㩨䨮䵻嘒嚖彗慧暳槥櫘熭篲蔧轊鏏雪
彘	彘璏
彝	彝彞
彡	㣌䀐䑣彡杉衫釤钐
彤	彤浵肜
彥	偐喭嵃彥彦楌諺谚遃顏顔颜齴
彪	䬌彪淲滮
彬	彬虨霦
彭	嘭彭憉澎膨蟚蟛
彳	彳
役	䓈坄垼役椺炈疫豛鈠
後	後
徙	屣徙簁縰蓰褷
從	㢔㼻䐫䗥䙕䡮傱嵸從怂慫摐暰枞樅熧瑽疭瘲磫縱纵聳苁蓯豵蹤鏦
御	䥏御禦篽籞蘌
微	㵟䉠䥩媺幑微徽溦癓矀薇覹鰴黴
徵	徵惩懲澂癥
徹	㯙䒆彻徹撤澈轍辙
心	伈吣心杺沁
必	㘠䀣䏟䖩䩛䪐䫾佖咇妼必怭柲毖泌珌祕秘苾虙覕邲鉍铋閟飶馝駜鮅鴓
志	䓌娡志痣誌
忝	㮇忝悿添舔菾
念	䭃唸埝念惗捻敜棯淰稔腍菍諗谂趝錜
忽	㧾䬍忽惚淴
思	䚡偲崽思恖愢揌楒毸禗緦缌罳腮葸諰顋颸飔鰓鳃
恩	嗯恩煾
息	㮩㴧䭒媳息熄瘜蒠鄎
悉	㴽䊝僁悉窸蟋
悤	㷓䆫䉥䗓偬傯幒忩怱总悤愡憁憽揔摠楤檧熜牎牕璁窓窻緫總繱聦聪聰葱蔥謥鍯騘驄骢
惠	惠憓橞潓穗繐蕙蟪譓鏸韢
惢	惢繠蕊蘂
意	䗷亿億噫忆意憶檍澺癔繶臆薏譩醷鷾
愛	僾叆嗳噯愛暧曖爱瑷璦瞹薆靉
感	䃭䉞䫲感憾撼轗鱤
慮	儢勴慮摅攄櫖滤濾爈藘虑鑢
慶	庆慶羻
憂	㱊优優嚘憂懮櫌瀀獶纋耰鄾
憲	䘆䜢宪幰憲攇瀗
戈	㳀划戈鳶鸢
戉	㞽㧔䋐䎀䟠䬂怴戉樾泧狘眓越鉞钺
戊	戊茂
戌	㖅戌珬銊
戍	㲓戍
戎	㣝㭜娀戎狨絨绒茙駥
成	䫆城墭宬成晟珹盛筬誠诚郕
我	㧴䄉俄哦娥峨峩我涐睋硪莪蛾誐餓饿騀鵝鹅
戒	㖑㳦悈戒械祴裓誡诫駴
戔	㟞㣤㹽䉔䎒䏼䗃䴼俴刬剗嶘帴戋戔栈棧残殘浅淺溅濺牋琖盏盞笺箋籛綫虥諓賤贱践踐輚醆錢钱餞饯
或	㖪㚜㰲䂸䬎䮙域彧惑或掝棫淢琙稶緎罭聝蜮閾阈馘魊
戚	㗤䙘傶嘁墄慼慽戚摵槭磩縬蹙鏚顣
戛	嘎戛
戜	䟈戜鐵铁驖
戟	戟撠
戠	帜幟戠樴炽熾織织职職膱蟙識识軄
截	㵶䕙䘁䟌䰏䶪嶻巀截蠽
戴	戴襶
戶	䋀僱帍戶户戸戽扈昈沪滬簄雇頋顧顾
戾	㑦㪐䓞唳悷戾捩泪淚綟蜧錑
所	㫹所齭
扁	㲢㻞㼐㾫偏匾媥徧惼扁揙斒楄牑猵甂瘪癟碥篇糄編编翩艑萹蝙褊諞谝蹁遍騗騙骗鯿鳊
扇	傓扇搧煽
手	手杽
才	䊷䞗䴭才材豺財财鼒
折	㑜㝂䀸䇽䏳䟷䩢䭁哲哳娎悊折晢晣浙焎狾硩蜇誓踅逝銴
拋	抛拋
拜	拜湃
拶	㳨拶
掃	埽扫掃
支	㩼㩽㲍㽻䃽䅩䚳䝸䞚䡋䧴䰙伎吱妓屐岐庋庪忮技支攱枝歧汥翄翅肢芰蚑衼豉跂頍馶鬾鳷
收	收荍
攸	㫍㶖䩦修倏倐儵悠攸樇浟滫筱絛绦翛脩莜蓨虪跾鋚鞗鯈
敄	㡔㮘䋷䓮䜼䨁务務堥婺嵍愗敄楘瞀蓩蝥鍪雾霚霧霿鞪騖骛鶩鹜
敏	慜敏鰵
敕	勅慗敕遫鷘
敖	䦋䫨傲嗷嗸嫯嶅摮敖滶熬獒磝聱蔜螯謷遨鏊驁骜鰲鳌鷔鼇
敝	䌘嫳币幣弊彆憋撆撇敝斃暼毙潎瞥蔽虌襒蹩鄨鐅鱉鳖鷩鼈
敞	僘廠敞氅
敢	㒈㺖噉憨撖敢橄澉瞰譀豃闞阚
散	䉈撒散潸糤繖鏾霰饊
敦	䇏啍噋埻墩弴惇憝憞敦暾淳炖焞燉犉稕諄譈谆醇錞鐓驐鶉鷻鹑
敫	㰾䚫儌噭墽徼憿敫檄激燩獥璬皦礉窍竅繳缴薂覈譥邀鸄
敬	儆惊憼擎敬曔檠璥蟼警驚
數	擞擻数數籔薮藪
文	䘇䰚彣忞抆文旻旼汶玟玫盿紊紋纹蚊雯馼鳼鼤
斗	㪷抖斗斢枓蚪鈄阧
料	料炓
斛	䈸斛槲蔛
斝	斝
斤	㹞䓄䖐劤听圻垽岓庍忻掀斤斦旂昕欣沂炘焮玂祈芹菦蕲蘄蚚訢赾近邤釿靳頎颀齗
斥	㿭䞣坼拆斥柝跅
斬	㨻䟅䤔䭕䳻堑塹壍嬱崭嶃嶄惭慙慚摲斩斬暂暫椠槧渐漸獑蔪螹覱蹔錾鏨
斯	㒋㯕㽄䔮凘厮嘶廝撕斯澌燍蟴鐁
新	㜪新薪
斲	斲
斷	䠪断斷
方	䄱仿倣坊妨彷房放方昉枋汸淓牥瓬祊紡纺肪舫芳蚄訪访趽邡鈁钫閍防雱髣魴鲂鴋鶭
於	唹扵於棜淤瘀箊菸閼阏
施	㒾䗐崺拖施暆箷絁葹迤鍦駞
斿	斿游蝣遊
旁	䄘䅭䒍䠙䨦傍嗙徬搒旁榜滂牓磅篣縍膀蒡螃謗谤鎊镑霶騯髈
旅	㭚䮉旅玈祣膂
旋	㳬䁢䗠嫙旋漩琁璇縼蜁鏇
族	䃚嗾族瘯簇蔟鏃镞鷟
无	无
旡	旡炁
既	㮣䀈䊠䐴嘅塈慨摡既旣暨曁概槩櫭溉穊蔇鱀黖
日	䖑䵒日汨衵馹
旦	㡺䋎䖧䦔䵣但呾坦妲怛担旦炟狚疸笪胆袒觛靼鴠
旨	㚛㞓㞛㴯恉指旨栺脂詣诣鮨鴲
早	愺早皁皂騲
旬	㧦㰬䀏䖲侚咰姰峋徇恂惸旬槆殉洵珣眴筍箰絢绚荀詢询迿郇
旱	㪋䏷䓍䛞䳚垾娨悍捍旱桿焊皔睅稈蔊趕銲駻
旵	旵
昆	䃂䚠倱崐崑惃掍昆晜棍混焜猑琨箟緄菎蜫輥辊錕锟餛馄騉鯤鲲鵾
昌	倡唱娼昌猖琩菖裮閶阊鯧鲳
明	䳟奣明朙盟莔萌
昏	䫒婚惛捪昏昬棔殙湣痻睧緍緡缗錉鍲閽阍
易	㑥䯜儩剔埸惕敡易晹痬睗緆舓蜴裼賜赐踢逷錫锡鬄
昔	㳻䄍䇎䜺䣢䱜借剒厝唶庴惜措斮昔棤焟猎皵矠碏簎籍耤腊藉蜡諎趞踖躤逪醋錯错鵲鹊齰
昚	昚
昜	㼒䑗䵮伤偒傷啺场場塲婸崵愓慯扬揚摥敭旸昜暘暢杨楊殇殤汤湯炀烫煬燙瑒璗畅畼疡瘍盪砀碭禓簜肠腸荡蕩薚蝪觞觴諹踼輰逿鍚鐋钖阳陽颺餳鰑鸉
星	惺星曐猩睲篂腥醒鯹
春	䐏偆惷春椿瑃蠢賰踳鬊
是	㓳㖷㼵䈕䊓䐎䚣匙堤媞寔徥提是湜瑅睼禔緹缇翨蝭褆諟趧踶遈醍鍉隄鞮題题騠鯷
昱	喅昱煜
昶	昶
昷	㼔䯠嗢塭媪媼愠慍揾搵昷榅榲殟氲氳温溫煴熅瘟緼縕腽膃蒀蒕蕰蕴薀藴蘊蝹褞豱輼轀辒酝醖醞韞韫馧
時	埘塒时時榯莳蒔鰣鲥
晃	䁜幌晃晄榥滉
晉	㬜戩戬搢晉晋榗瑨縉缙鄑
晏	䁙晏騴鷃
晝	昼晝
普	普譜谱
景	䭘影憬景暻澋璟
晶	晶
暑	暑
暴	㩧㿺嚗懪暴曝瀑爆犦襮謈
暹	暹
曄	晔曄曅烨燁爗皣瞱
曇	壜昙曇
曰	䫻曰欥汩蚎
曲	䒼曲
曳	㡼㹭䄿䇩䎈䒶拽曳曵洩跩
更	䢚哽埂挭更梗浭硬稉粳綆绠郠鞕骾鯁鲠
曷	㔠㵣㵧㿣䅥䈓䋵䔽䔾䦪䫘偈喝堨嵑愒揭擖暍曷朅楬歇毼渴猲獦碣竭羯葛蔼藒藹蝎蠍褐謁谒輵遏鍻霭靄鞨餲馤鶡鹖齃
書	书書
曹	㡟㷮䄚䏆䐬傮嘈慒曹槽漕糟艚蓸螬褿遭醩
曼	㿸䅼䊡䜱䝢䟂䡬墁嫚幔慢曼槾漫獌縵缦蔓蟃謾谩鏝镘饅馒鬘鰻鳗
曾	㬝䁬䆵䎖䒏䙢䰝僧噌增层層嶒憎曾橧潧熷甑矰磳竲繒缯罾譄贈赠蹭鄫鏳驓鬙
替	㬱僣暜替
最	䴝嘬撮最繓蕞襊
朁	㔆㣅㻸㿊䁮䅾䍼䐶䣟䣠䤐䫬䭙僭噆嶜憯撍昝朁潛潜熸簪糣蚕蠶譖谮鐕
會	䢈䯤䵳䶐会侩儈刽劊哙噲嬒廥懀旝會桧檜浍澮烩燴狯獪璯瞺禬繪绘脍膾荟薈襘譮郐鄶鬠鱠鲙
月	䎳䚴刖外抈月枂玥蚏跀鈅
有	䀁䒴䞥䳑䵋侑哊囿姷宥戫有栯洧烠珛痏絠蛕賄贿郁酭鮪鲔
朋	㥊倗堋弸掤朋棚淜硼輣鬅鵬鹏
服	服棴箙菔鵩
朏	昢朏
朔	塑愬朔槊溯蒴遡
朕	㑞儯勝塍媵幐朕栚榺滕眹籐縢腾膡蕂藤螣誊謄賸騰鰧黱
朝	嘲庙廟朝潮
朢	朢
木	木沐蚞霂
未	佅味妹寐昧未沬眛菋魅鮇
末	䬴䱅䴲妺帓怽抹昩末枺沫眜秣粖茉袜靺韎
本	㡷本笨缽翉苯鉢钵
札	㳐扎札紮蚻
术	㾁䟣怵朮术沭炢秫蒁術訹述
朱	㦵㸡㼡䇬䎷侏咮姝朱株殊洙珠硃祩絑茱蛛袾誅诛趎跦邾銖铢陎鮢鴸鼄
朵	㛊䤪刴剁垛挆朵朶桗跺躲
朿	㢀㾊刺刾憡拺擌朿栜洓策莿跡迹
李	李
杏	杏莕
束	㑛嗽娕悚捒摗束梀樕欶殐涑漱瘶竦綀蔌藗誎速遬鏉餗駷
東	㼯䍶䰤䵔东倲冻凍埬崠東栋棟涷菄蝀鯟鶇
杲	杲菒
杳	杳
松	㮤倯凇崧松淞硹菘蜙鬆
析	㭊㱤䨛惁晰析淅皙菥蜤蜥
林	啉婪惏林棽淋漤琳痳箖綝罧菻郴醂霖
枚	枚
果	㷄㾧䊬䴹堁夥婐惈敤果棵猓祼稞窠粿菓蜾裸裹課课踝躶輠顆颗髁
枼	㵩䁋䈎䐑䑜䕈䚢䢡䥡偞喋堞媟屟屧弽惵揲枼楪殜渫煠牃牒碟緤葉蝶褋諜谍蹀鍱鞢韘鰈鲽
枿	枿
某	䤂媒某煤禖腜謀谋
染	媣染
柔	㽥䰆揉柔楺煣猱瑈糅腬葇蝚蹂輮鍒鞣韖騥鰇鶔
查	喳查査楂渣碴
柬	㪝㼑堜拣揀暕柬楝湅炼煉練练萰諫谏鍊鰊
柰	㲡奈捺柰渿
栗	㗚㟳㮚䔁凓塛慄搮栗溧瑮篥鷅麜
桀	傑嵥搩杰桀榤滐謋
桑	嗓搡桑桒磉顙颡
桼	㓼㯃䜉䣛䰍厀桼漆膝
條	条條樤涤滌窱篠蓧鰷鲦
梟	枭梟蟂鄡
棗	枣棗
棘	㻷棘蕀襋
棥	䫶攀棥樊矾礬蠜襻
森	森
椎	㢈㮅䜃䶆堆嵟推椎碓脽萑蓷誰谁趡錐锥陮顀騅骓魋鵻
楚	儊憷楚濋础礎齼
業	㗼㸣䌜䧨业嶪業澲礏邺鄴驜鸈
樂	㜰䁻䑈䟏䠯䤕乐嚛擽栎樂櫟泺濼烁爍瓅皪砾礫纅藥觻跞躒轢轹鑠铄
橇	撬橇
橐	橐螙蠹驝
欠	㐸䇜坎崁扻杴欠砍芡鍁
次	䆅䪡䯸䳐佽咨垐姿恣楶次澬瓷粢絘茨薋蠀諮資资趑餈
欮	欮瘚闕阙
欻	㗵欻
款	䄐䥗䲌欵款歀窾
止	䊼址杫止沚祉芷趾阯齒齿
正	䋊佂征怔政整正症眐竀証鉦钲鴊
此	㠿㧗㧘㭰㰣㾹䂑䖪些佌呰啙嘴姕庛柴此泚玼疵皉眥眦砦祡紫胔茈觜訾訿貲赀跐鈭雌頾頿飺骴髭鮆鴜齜龇
步	步荹踄
武	娬武珷碔賦赋陚鵡鹉
歬	歬
歰	㒊歰涩澀澁
歲	䮹刿劌哕噦奯岁歲濊獩秽穢翙翽薉鐬顪饖
歷	䍥䍽䟐䥶坜壢攊枥櫪歷沥瀝癧藶雳靂
歸	㱕岿巋归歸蘬
歺	歹歺
死	死
殳	䟝䬦吺投杸殳祋酘骰
段	椴段毈瑖碫緞缎腶鍛锻
殷	㐆慇殷溵磤
殸	䡰声殸磬罄聲謦馨
殹	㗨㙠㿄䃜嫕嫛殹毉瞖繄翳蘙蠮贀醫鷖鹥黳
殺	䓭刹剎摋杀榝殺煞蔱鎩铩閷
殿	壂殿澱臀
毀	㩓檓毀毁毇燬譭
毄	击墼擊檕毄礊繫罊蘻蟿轚
毋	毋
毌	毌
母	䳇呣姆拇母胟苺
每	㙁䊈䍙䱕侮嗨悔挴晦梅毎每海畮痗脢莓誨诲踇酶鋂霉
毐	毐
毒	毒瑇碡纛蝳
比	䃾䉾䚹仳吡妣屁庇批枇比沘玭琵砒秕笓粊紕纰肶芘蚍豼鈚阰魮
毘	㔡㡙㮰䠘媲毗毘磇篦膍蓖螕貔鎞
毚	㺥䪌儳劖嚵巉搀攙欃毚瀺纔艬讒谗酁鑱镵饞馋
毛	㕰㲏㲝䋃䫽旄枆毛毣氂牦眊秏耄耗芼覒酕髦
毳	㦌㯔毳竁膬
氏	䉻䟗䲬坁帋忯扺氏汦疧眂祇秖紙纸舐芪蚔衹軝
氐	㪆㲳䓜䟡䧑䩚䬫低厎坻奃岻底弤彽抵柢氐泜牴疷眡砥祗秪羝胝茋蚳袛觝詆诋貾趆軧邸阺骶鴟鸱
民	㨉䟨䪸刡岷怋愍抿敃暋民泯珉眠笢罠蟁鈱
氒	氒
气	㧉刏忥忾愾气氣汽熂犔鎎霼餼饩
水	㽷水沝
氶	䒱䕄丞承拯氶烝篜脀蒸
永	咏栐永泳詠
氾	䀀氾犯笵範范
求	䟵䣇俅捄救梂殏毬求球絿脙莍蛷觩賕赇逑銶
汓	汓
沒	歿殁沒没莈
沓	㛥㧺㭼㹺䂿䈋䍝䓠䵬沓涾濌誻踏錔鞜
沙	㲚䓾䤬娑挱挲桫桬沙砂硰紗纱莎莏裟髿魦鯊鲨
泉	泉灥線线腺葲
法	法灋珐琺
波	婆波碆菠蔢
津	津葏
派	㭛䤨派眽脈脉衇霡霢
涉	䤮涉
淮	㨤匯擓汇淮
淵	䨊囦奫婣淵渊裫鼘
淼	淼
渠	䝣淭渠璖磲蕖蟝
湌	湌
火	伙火邩
灰	㷇䈐恢灰盔脄詼诙
災	災
灾	灾
炅	昋炅煚
炎	㰊䆱䎦䕭倓剡啖惔扊掞棪毯氮淡炎焱燄燅琰痰睒緂腅舕菼裧覢談谈賧郯錟锬餤
炙	䂹炙
炭	㛶㨏湠炭碳
烏	㮧䃖䡧乌呜嗚坞塢歍溩烏瑦螐邬鄔鎢钨隖鰞
烕	搣滅灭烕
焉	㯊䗡傿嘕嫣漹焉蔫鄢
焚	焚
無	㒇䉑䌗䍢䒉儛墲妩嫵幠庑廡怃憮抚撫橅潕無璑甒瞴膴舞芜蕪譕鄦鷡
焦	㲬䌭䩌僬劁噍嶕憔撨樵潐焦燋癄瞧礁穛膲蕉蟭譙谯趭醮鐎顦鷦鹪
然	㒄㜣㦓㬗嘫撚橪然燃繎蹨
焸	焸
煩	烦煩薠
熊	熊
熏	勲勳壎曛櫄熏燻爋獯纁臐薰醺
熒	㒌㽦䁝䎕䪯塋嫈嵘嵤嶸榮檾滎滢濙濴瀅焭煢熒營瑩禜縈罃茔茕荣荥荧莹莺萤营萦蝾螢蠑褮覮謍醟鎣鶯
燊	燊
燕	㬫嚥嬿燕讌酀醼驠鷰
燮	燮躞
爨	爨
爪	䝖抓爪笊
爭	䋫䱢争净凈埩峥崢挣掙棦浄淨爭狰猙琤睁睜竫筝箏諍诤錚铮鬇
爯	偁爯称稱
爰	㬊䁔䈠喛媛嵈愋援暖楥湲煖爰猨瑗緩缓蝯褑諼谖鍰锾鰀鶢
爲	㺔䞈䦱䧦为伪偽僞儰噅噕嬀寪撝潙為爲蔿蘤蟡譌鄬
爵	㩱䂃嚼灂爝爵皭穱釂
父	㕮䭸斧滏父蚥釜
爻	㤊䂚䋂䡈敎教爻笅
爽	㼽䫪傸塽摤樉漺爽磢騻鷞
爾	㜷䌳䥸壐嬭彌擟檷沵濔瀰爾狝猕獮獼玺璽瓕祢禰籋薾邇鑈镾鸍
爿	㽵䍧妆妝床戕斨爿牀牂状狀
牆	墙嫱嬙廧樯檣牆蔷薔蘠
片	䏒沜片
牖	牖
牙	㤉䓉厊呀岈庌枒牙犽琊疨砑芽衺訝讶谺迓邪釾雅颬鴉鸦齖
牛	牛
牟	侔劺恈牟眸蛑鴾麰
牡	牡
牢	㟉䜮哰牢窂
牧	牧
特	特
牽	㯠牵牽縴
犀	摨犀
犇	犇
犬	汱犬畎
犮	㺴䣮䮂䯋䳊冹坺妭帗拔炦犮盋瞂祓紱绂翇胈苃茇菝蛂袚跋軷鈸钹韍颰馛髮魃黻
狂	㤮俇狂誑诳逛鵟
狄	悐梑狄荻逖
狊	䠐湨犑狊瞁郹闃阒鶪鼳
狖	抭狖貁
猋	䔸猋贆飆飙
猌	慭憖猌
猒	猒
獄	嶽狱獄鸑
獸	兽嘼獸
獻	㩵䡾囐巘献獻瓛讞谳钀齾
玄	䝮䩙䮄伭泫炫玄玆玹痃眩絃胘舷蚿衒袨詃鉉铉
率	䔞䢦摔率繂膟蟀
玉	匤玉玨珏砡鈺钰頊顼鳿
玊	玊
王	㳹䍿彺旺枉汪王蚟軖迋
班	斑班
瑟	瑟璱飋
瑣	䐝䣔䵀唢嗩溑琐瑣鎖锁
瓜	㧓㽿䉉䠚呱坬孤弧搲攨柧泒狐瓜畖窊箍箛罛胍苽菰觚軱
瓦	瓦邷
甘	㟛䇞䗣坩姏嵌拑柑泔甘甝疳箝紺绀苷蚶邯酣鉗钳魽黚
甚	㴴䤁䨢䫖偡勘堪墈媅嵁愖戡揕斟椹歁湛煁甚瘎碪磡糂葚諶谌踸鍖黮
甜	䄼恬栝湉狧甜銛铦餂
生	䴤夝姓性旌牲狌珄生甥笙胜貹鉎鮏鼪
甡	甡
產	㦃㹌䊲䐮产剷嵼摌浐滻產産簅鏟铲
甤	甤蕤
用	佣用
甫	㕊㩤䈻䔕䩉䪔䮒俌匍哺圃埔峬庯悑捕敷旉晡浦烳璷甫痡秿簠脯莆葡蒱蒲蜅补補誧豧輔辅逋郙酺鋪铺陠餔鬴鯆鵏麱黼
甬	㪌㼧俑勇埇恿悀慂捅桶氄涌湧甬痛筩蓪蛹誦诵踊踴通銿
田	䟧䡘佃沺田甸畋鈿钿
由	㣙㽕㾄䅢䛆䨤伷冑妯宙岫怞抽柚油牰由秞笛紬胄舳苖菗蚰袖軸轴迪邮釉鈾铀頔駎鮋鼬
甲	䆘䛅匣呷岬庘押柙炠狎玾甲笚翈胛鉀钾閘闸鴨鸭
申	䰠伸呻抻朄柛申电眒砷神紳绅胂訷電
男	男
甹	俜娉梬甹聘騁骋
甽	甽
甾	㿳䎩䣎椔淄湽甾緇缁菑輜辎錙锱鯔鲻鶅
畀	淠畀痹箅
畏	㛱㞇㱬㾯䋿偎喂嵔揋椳渨煨猥畏碨腲葨鍡隈餵鰃
畐	㽬䈏䔰䮠䵗偪副匐堛富幅愊揊楅湢畐疈福稫腷葍蔔蝠褔踾輻辐逼鶝
留	㨨㽌塯嵧廇榴溜瑠留瘤籀罶蒥遛鎦镏霤飀飗餾馏騮骝鰡鶹鹠
畜	㜅傗慉搐滀畜稸蓄鄐
畞	亩畝畞
畟	㮨㹄溭畟稷謖谡
畢	㓖㪤㮿㻫䟆彃毕滭熚畢筚篳縪罼荜蓽跸蹕鏎韠饆鷝
番	㢖㺕㽃䮳墦嶓幡播旛橎潘燔璠番皤磻籓繙羳翻膰蕃藩蟠襎譒蹯轓鄱鐇飜鱕鷭
畫	㗲㦎㩇䐸劃婳嫿澅画畫繣
異	㔴䔬廙潩瀷熼異禩翼趩
當	㼕儅噹当挡擋档檔珰璫當筜簹蟷裆襠譡鐺铛闣
畺	㹔䗵䲔僵壃彊橿殭畕畺疆礓繮缰薑韁麠
畾	㔣㠥㵽儡壘攂櫐櫑瓃畾礧罍藟蘽讄轠鑘鸓
疊	㩹䴑叠曡氎疊
疋	㽰㿿䝪梳疋疎疏蔬
疌	倢啑婕寁崨徢捷疀疌睫箑緁萐蜨誱踕
疐	嚏懥疐
疑	㘈㽈䰯儗凝嶷懝拟擬疑癡碍礙薿觺譺
疒	疒
疢	疢
疾	㑵嫉愱槉疾蒺
癶	癶
癸	䳫戣揆楑湀猤癸睽聧葵藈鄈鍨闋阕騤
癹	发癹
登	㡧㲪㽅䆸䔲䮴䳾僜凳墱嶝憕撜橙澄灯燈璒登瞪磴簦膯覴證证蹬邓鄧鐙镫隥鼟
發	䉬䚨废廢拨撥橃泼潑癈發襏酦醱鏺驋鱍
白	㼟伯啪帕帛怕拍敀柏泊湐珀白碧箔粕胉舶迫鉑铂魄鮊
百	㹮佰咟帞洦百皕蛨袹貊銆陌
皀	匓孂廄廏皀簋鵖
皃	㦝䡚䫉皃藐貌邈
皆	偕喈堦揩楷湝瑎皆稭蝔諧谐鍇锴阶階鶛龤
皇	䄓䅣偟凰喤堭媓徨惶揘湟煌瑝皇皝篁艎葟蝗諻遑鍠锽隍韹餭騜
皋	㟸㤒㿁䆁䔌䚌䜂䜰䣗䫧嗥噑暤暭槔橰獆獋皋皐睾翱翺臯鷎鷱
皛	㵿皛
皮	㝿㢰㱟佊坡帔彼披旇柀狓玻疲皮破秛簸紴翍耚被詖貱跛鈹铍陂鞁頗颇駊骳髲鮍
皿	皿
盆	湓盆葐
盈	䋼楹盈
益	㱲䅬嗌搤溢益縊缢膉艗螠諡謚谥貖賹鎰镒隘鷁鹢齸
盍	㔩㕎㹤㾀䀷䖔䗘䫦劫厒嗑圔壒廅怯搕榼溘滟灩熆盍盖瞌砝磕篕艳艷蓋蜐豔鉣闔阖饁馌鰪
盜	盗盜
盡	儘壗尽濜烬燼璶盡荩藎賮
監	㔋㜮㯺㺝㽉䆾䰐儖嚂壏尴尷懢揽擥攬榄槛檻欖滥濫爁监監礛篮籃纜舰艦蓝藍蘫褴襤覽览轞鉴鑑鑒
盥	盥
盧	㠠㪭㿖䰕卢嚧垆壚庐廬攎栌櫨泸瀘炉爐獹瓐盧矑籚纑罏胪臚舻艫芦蘆蠦轤轳鑪顱颅驢驴髗鱸鲈鸕鸬黸
盩	盩
盭	盭
目	目瞐苜
直	㨁䐈值埴德惪植殖淔犆直稙置
相	厢廂想湘相箱緗缃葙
盾	㡒䋸䛻循揗楯盾腯輴遁鍎鶞
省	㮐㼳㾪䚇渻省眚箵
眉	䉋媚嵋楣湄煝瑂眉睂篃葿蝞郿鶥
看	看
眔	䜚䳴嚃眔遝
真	㒹䐜䡩傎厧嗔填寘巅巔愼慎搷槙滇瑱瘨癫癲眞真瞋磌禛稹窴縝缜蒖謓蹎鎭鎮镇闐阗顛颠鬒鷏黰齻
眾	䝦众潨眾衆
睘	䁵儇噮圜嬛寰彋懁擐檈澴獧环環癏睘糫繯缳翾蠉譞轘还還鐶镮闤阛鬟
睪	㘁䁺䐾䕪凙圛墿峄嶧怿懌择擇斁檡殬泽澤燡睪箨籜繹绎萚蘀蠌襗譯译醳释釋鐸铎驛驿鸅
睰	睰
睿	䜜叡壡濬璿睿
瞢	㝱䉚䒐䠢䲛夢懜懵梦甍瞢蘉鄸
瞿	忂惧懼戵欋氍灈癯瞿臞蠷衢躣鑺鸜
矍	䂄䢲䣤彏戄攫玃矍籰貜躩钁
矛	懋楙矛罞茅蟊袤雺髳鶜
矞	䆷䤎劀噊憰橘潏燏獝璚瞲矞繘譎谲遹鐍霱驈鱊鷸鹬
矢	䀢䀵䒨矢薙雉
矣	㶼俟唉埃娭挨欸涘矣竢誒诶騃
知	䚐䝷䣽䵹智潪痴知蜘踟鼅
矨	矨
石	䄷䞠䲽妒妬拓斫柘沰石硕碩磔磭祏袥跖鉐鼫
砅	砅
砉	剨湱砉
磊	㰁磊藞
示	沶狋眎示祁視视
礼	礼
祘	祘蒜
祝	呪咒柷祝
祟	䔴䳳祟贅赘
票	㟽㠒㬓䏇僄剽勡嘌嫖幖彯慓摽旚标標漂熛瓢瘭瞟票篻縹缥翲膘蔈薸螵褾醥鏢镖顠飄飘驃骠鰾鳔
祭	㗫㡜䏅䕓傺察摖擦瘵祭穄詧际際鰶
禁	㦗㩒㯲䫴僸凚噤澿禁襟齽
禸	禸
禹	㝢䨞楀瑀禹聥萭踽鄅齲龋
禺	㼴䴁偶喁堣媀寓嵎庽愚湡禺耦蕅藕遇鍝隅顒颙髃鰅齵
离	㰚㷰䅻䍦摛攡樆漓灕璃离篱籬縭缡罹蓠蘺螭褵謧醨離魑黐
禼	禼窃竊
禽	噙擒檎禽
禾	䒩俰咊和盉禾鉌龢
禿	䛢禿秃鵚
秀	琇秀莠蜏誘诱透銹
秉	棅秉
秋	㡑㵞㾭䎿䨂䵸僽啾愀愁揪揫楸湫甃瞅秋秌篍萩醔鍫鍬锹鞦鬏鰍鳅鶖鹙
科	䈖犐科萪蝌
秝	秝
秦	搸榛溱秦臻蓁螓轃
秭	姊柹秭笫胏趀
稽	㮷䭬嵇稽
穆	㣎穆
穌	㢝囌稣穌苏蘇酥
穴	㧒䋉䛎䴳坹泬穴袕鴪
穹	䛪䠻焪穹
空	㾤䅝倥啌埪崆悾控椌涳硿空箜羫腔谾鞚鵼
穿	穿
突	堗宊揬突葖鶟鼵
竄	撺攛窜竄蹿躥鑹
立	㕇㱞䶘啦垃岦拉泣湆砬立笠粒苙菈雴颯飒鴗
竟	境摬樈滰獍璄竟鏡镜
章	㢓墇嫜嶂幛彰慞暲樟漳獐璋瘴章蔁蟑鄣障麞
童	㼿䂌䝑䡴䴀僮噇幢憧撞曈橦潼犝疃瞳穜童罿艟蕫蹱鐘钟
竵	竵
競	竞競誩
竹	竹竺笃筑築篤茿
笑	㗛笑
筆	㻶潷笔筆
等	等
筋	䈥筋
筭	笇筭
筮	噬澨筮簭遾
算	㔍䉵䵵匴攥算篡篹繤纂
節	㘉㸅䲙幯擳栉櫛瀄疖癤節节蠞
米	䋛䍘䱊侎冞咪攗敉洣眯瞇米蔝蘪謎谜迷麊麋
籴	籴糴
粜	粜糶
粟	㔄憟粟
粥	粥鬻
粦	㷠䗲僯壣嶙憐撛橉潾燐獜璘甐疄瞵磷粦粼繗翷膦轔辚遴邻鄰鏻驎鱗鳞麟
粲	㛑殩灿燦璨粲薒餐
粵	粤粵
糞	䆏瀵粪糞
糸	糸
系	係系
約	哟喲箹約约药葯
素	㨞䛾傃嗉塐素膆
索	㮦䞽嗦溹索
累	䉂嫘摞樏瘰磥累縲缧蔂螺鏍镙騾骡
絕	㔢絕绝脃脆蕝
絲	丝絲蕬鷥鸶
綌	㮝綌郤
緐	㶗緐
緜	棉矊綿緜绵
縣	县悬懸縣
繁	瀪瀿繁蘩
繇	㘥櫾繇蘨
繭	繭茧蠒襺
纍	㶟儽欙纍纝虆
缶	㓡㯱宝寶珤缶缹缻
网	网蛧
罔	惘棢網罔菵誷輞辋魍
罙	探棎深琛穼罙賝
罪	㠑䊫罪
罰	罚罰藅
署	曙署薯
罷	㔥䥯摆擺犤矲罢罴罷羆藣襬
羅	㑩㦬㿚儸啰囉攞曪欏猡玀箩籮罗羅萝蘿逻邏鑼锣饠
羈	羁羇羈覊
羊	㨾㺊䭐佯养姜庠徉恙样樣氧洋漾瀁烊痒癢眻祥羊羕翔蛘詳详養鯗鲞鴹
羋	羋芈蝆
羌	唴猐羌蜣
羍	羍
美	媄渼美鎂镁
羑	㕗羑
羔	㚠䅵䫞溔禚窑窯糕羔餻
義	㕒㠖䣡䴊义仪儀曦檥牺犧礒羛義羲舣艤蚁蟻議议轙
羴	羴羼
羸	㱻䇔䌴羸臝蠃驘鸁
羹	羹
羽	䣁䨒栩珝祤羽翵詡诩頨
翁	㮬䈵䐥䩺䱵勜嗡塕慃暡滃翁蓊螉
翌	翊翌蛡
翏	㶀㺒䀊䚧䰘䵏僇剹勠嘐嫪寥廖憀戮摎樛漻熮璆疁瘳磟穋繆缪翏膠蓼蟉謬谬豂賿轇鄝醪鏐镠顟飂髎鷚鹨
習	㗩䌌䐲䒁习慴摺槢熠磖習褶謵霫飁騽鰼
翕	㩉㯓噏嬆歙潝熻翕翖蹹闟
翟	㪬㺟㿑䊮䌦䢰嬥戳擢曜櫂濯燿籊翟耀藋蠗趯跃躍鸐
翠	噿濢翠臎
老	佬恅栳老
考	拷栲洘烤考銬铐
者	㨋㸙䐗䘄䬡䰞䰩堵奢奲帾撦暏楮渚煑煮瘏睹緒绪翥者褚覩觰賭赌赭醏鍺锗闍陼
耆	䅲嗜愭榰耆蓍鬐鰭鳍
而	㾍䎠峏恧栭洏而耏耐胹輀陑陾髵鮞鲕鴯
耎	㨎㬉㮕㼲䓴䙇䞂偄堧媆愞渜煗瑌碝稬緛耎腝蝡輭餪
耑	㪜䵎偳剬喘圌惴揣椯歂湍煓瑞端篅耑腨褍諯貒踹輲遄鍴顓颛
耒	䒹䣂洡耒誄诔銇頛
耳	㛅䋙䎶䏪䣵佴刵咡恥毦洱珥眲耳耻聻衈誀餌饵駬髶
耴	㑙㡇㤴㭯㳧䎎䳖耴聑踂輒辄鮿
耶	椰爷爺瑘耶鎁
耷	㿴耷
耿	耿褧
聅	聅
聖	厅廳柽檉聖聽蛏蟶
聚	㔌䝒䠫聚藂鄹驟骤
聯	㶌关联聮聯関關
聶	㸎䝕嗫囁慑懾摄攝欇滠灄聂聶襵讘蹑躡鑷镊顳颞
聿	䋖䢖律硉聿葎銉
肅	㩋㪩䃤䎘䐹啸嘯彇橚歗潇潚瀟熽璛箫簫繡绣肃肅萧蕭蟰鏽锈驌骕鱐鷫鹔
肇	肁肇肈
肉	朒肉
肎	啃肎肯
肖	㲖㴥䈰䘯䴛俏削哨娋宵峭帩弰悄捎揱旓梢消潲焇痟睄矟硝稍筲箾綃绡肖艄莦蛸誚诮赵趙踃輎逍銷销陗霄鞘韒颵髾魈鮹
肘	疛紂纣肘葤討讨酎
肙	㘣㯞㾓䅌䣺䧎䬼剈埍娟弲悁捐梋涓焆狷琄瓹睊絹绢罥羂肙蜎鋗鞙駽鵑鹃
肩	掮猏肩菺顅鵳
肰	肰
育	䋭唷堉棛淯焴育蘛蜟逳錥
肴	㮁倄崤殽淆肴郩餚
肸	肸
胃	㥜䁌䬑喟媦彙彚渭煟猬緭胃蝟謂谓
背	偝揹背鄁
胡	㾰湖猢瑚箶糊胡葫蝴衚醐餬鬍鶘鹕
胤	胤酳
胥	㥠䈝䱬壻婿揟楈湑稰糈胥蝑諝谞醑
能	䘅态態能螚褦
脅	嗋愶搚熁胁脅
脊	塉瘠脊膌蹐鶺鹡
膚	膚
臣	䛗䢻嚚挋臣茞頣
臤	㘋㹂䁂䌑䵖坚堅悭慳掔摼硻礥紧緊肾腎臔臤菣藖蜸賢贤鋻鏗铿鰹鲣
臥	卧臥
臦	煛臦臩
臧	脏臟臧藏贓赃
臨	临瀶臨
自	垍洎自臮詯郋
臬	㓷劓寱嵲甈臬臲鎳镍闑
臭	䠗嗅殠糗臭齅
臱	㝰䟍䫵䰓櫋矏笾籩臱边邊
至	㗧䏄侄咥垤姪庢恎挃晊桎痓秷窒絰绖耋胵至荎蛭螲跮輊轾郅銍铚駤鵄
致	㨖䞃緻致
臸	臸
臺	㘆儓嬯懛擡檯籉臺薹
臼	䊆䳎匶旧桕臼舅舊齨
臽	㡊䐄䘓䱤啗埳惂掐欿淊焰窞臽萏蜭諂谄輡錎陷餡馅鵮
臾	㥚㳛庾斞楰腴臾萸諛谀
臿	㛼㞚䙄䛽䮢偛喢插敮歃牐臿鍤锸
舀	䈱幍慆搯槄滔瑫稻縚舀謟蹈韜韬
舁	舁舆輿
舂	㦼䄝䚎憃摏桩樁舂蹖
舄	䉣写寫泻潟瀉獡磶舄蕮
與	㦛㶛㺞䑂举嬩屿嶼擧攑旟榉櫸欤歟玙璵礜穥與舉藇誉譽鱮鸒
興	兴嬹臖興
舌	絬舌
舍	啥捨涻舍騇鵨
舛	舛荈
舜	僢瞬舜蕣
舝	舝
舟	侜矪舟輈辀鵃
般	䈲䰉媻幋搫搬槃瘢盘盤磐縏般螌鎜鞶
艮	䓳䦘䫀垠垦墾很恨恳懇拫根檭泿狠珢痕眼硍艮艰艱茛蛝詪豤跟銀银限鞎齦龈
良	㝗㟍䀶䕞䡙䯖俍剆哴埌娘崀廊悢朖朗桹榔欴浪狼琅瑯硠稂筤粮艆良莨蒗蓈蜋螂誏踉躴郎鋃锒閬阆駺
色	色赩
艸	艸草
艾	哎艾餀鴱
芇	芇
芟	芟
芻	㑳㮲䅳䐢䑼刍媰搊煼犓皱皺篘縐绉芻謅诌趋趨邹鄒雏雛騶驺鶵齺
苗	喵媌庿描猫瞄緢苗貓錨锚
若	䖃偌叒婼惹楉箬若蠚諾诺蹃逽鄀
英	㲟媖暎楧渶瑛英霙韺鶧
茍	茍
茸	䇯䩸搑榵穁茸
茻	茻
荅	㜓㯚劄嗒塔搭撘榙瘩答荅褡鞳
莫	募嗼塻墓嫫寞幕慔慕摸摹暮模漠獏瘼瞙糢膜莫蓦蟆謨谟貘鄚鏌镆饃馍驀鬕
莽	㬒䁳䒎䥈漭莽蟒蠎
菐	㲫㹒䑑䗱䧤䪁䴆僕噗墣幞撲樸濮獛璞穙纀菐襆蹼轐醭鏷
華	䔢华哗嘩崋桦樺華譁鏵铧鞾驊鷨
萈	宽寬臗萈髋髖
萬	䜕劢勱噧疠癘萬虿蠆蠇贎迈邁
著	擆櫡着箸著躇鐯
葬	葬髒
蒐	蒐
蒙	䑃䰒幪懞曚朦檬濛矇艨蒙蠓靀饛鸏
蒦	㠛㦜䨥䨼䪝劐嚄嬳彠护擭檴濩獲瓁矆穫臒获蒦蠖護鑊镬雘韄頀鱯鳠鸌
蓏	蓏
蔑	㒝㩢䩏䯦幭懱瀎礣篾蔑蠛衊襪韈韤鱴
蔡	䌨攃礤蔡
蕆	蒇蕆
薦	䍎瀳薦鞯韉
薨	薨
蘸	蘸
虎	䗂䰧唬琥萀虍虎虡諕雐
虐	疟瘧虐謔谑
虒	㔸㡗㥴㴲㾷䖙䚦䞾䫢䶵傂嗁搋擨榹歋磃禠篪虒螔褫謕蹏递遞鷈鼶
虔	㓺㗔榩虔鰬
處	䖏处處
虖	㙤㯉㻯嘑嫭歑滹罅虖謼
虘	㜘㢒㪥䁦䠡䣜䶥摣樝皻蔖虘覰覷觑謯
虛	㠊嘘噓墟歔虗虚虛驉魖
虜	㢚䲐掳擄艣虏虜鐪
虢	㶁虢
虣	虣
虤	虤
虫	虫
虺	䖵䖶虺豗
蚝	蚝
蚤	㕚慅搔溞瑵瘙糔蚤颾騷骚鰠鼜
蚩	嗤媸滍蚩
蜀	㒔㯮㻿䟉䫳䮷噣擉斀斣歜浊濁烛燭独獨臅蜀蠋襡触觸躅鐲镯韣髑鸀
蟲	䂈䳋瀜爞痋融蟲赨鉵
蠱	蛊蠱
蠲	蠲
血	䆝䒸䦗侐卹恤欰殈洫血賉
行	䯒桁洐珩筕絎绗胻荇蘅行衡
衍	愆衍
衛	㦣卫衛衞讆讏躗躛
衣	㕈㛄㥋䧇依庡扆衣
表	俵婊表裱錶
衰	榱簑縗缞蓑衰
袁	園榬溒猿薳袁轅辕远遠
袞	滚滾蔉衮袞
裔	㵝䕍裔
裘	裘
褎	褎
褭	嬝袅裊褭
褱	㜳坏壞怀懷櫰瀤瓌蘾褱
襄	㚂䉴䑋䖆儴儾勷嚷囊囔壤孃忀懹攘攮曩欀瀼灢獽瓖瓤禳穰纕蘘蠰襄讓让躟酿釀鑲镶饟驤骧鬤
襾	襾覀
西	卥哂栖毢洒粞茜西
要	㫏䙅䳩偠喓婹腰葽要闄騕
覃	㜤㶘㽑䊤䐺嘾憛撢橝潭燂瞫磹禫簟罈蕈藫蟫覃譚谭贉醰鐔镡驔鱏鷣
見	䙽䨘䩤俔哯垷岘峴挸晛涀现現睍砚硯笕筧粯絸苋莧蚬蜆見见靦
覎	覎
規	嫢摫槻瞡窥窺規规闚鬹
覓	䌐䮭漞覓覛觅
覞	覞
覡	覡觋
親	䞋亲儭嚫寴榇櫬瀙衬襯親
角	埆捔桷确角
解	䲒嶰廨懈檞澥獬繲薢蟹解邂
觱	觱
言	䇾䓂䴦唁圁狺琂言訔誾这這
訇	揈渹訇輷鍧
設	蔎設设
詈	㦒詈
詹	㙴䃫䠨䦲䪜儋噡幨憺擔檐澹甔瞻簷聸膽舚蟾襜詹譫谵贍赡韂黵
誗	誗
諸	㶆䃴储儲槠櫧藷蠩諸诸
謐	䤉榓謐谧
譶	䜆譶霅
谷	䀰䘱俗唂峪慾欲浴焀螸裕谷輍鋊鵒鹆
豆	㛒㰯䄈䛠䜴䱏侸剅头梪毭浢痘短竖竪脰荳裋豆豎逗郖鋀頭餖饾
豈	㨟㱯䐩䔇䠽䱺䶣凒凯凱剀剴呆垲塏岂嵦恺愷敳暟溰獃皑皚硙磑螘覬觊豈鎧铠闓闿隑顗颽
豊	䪆体澧禮豊軆醴體鱧鳢
豐	㒥㠦寷沣灃蘴豐酆麷
豕	豕
豖	㙇㧻䐁冢剢啄塚涿琢瘃諑诼豖
豙	䉨毅藙豙顡
豚	豚遯
象	像勨嶑橡潒蟓襐象鱌
豦	㘌㯫䆽䟊剧劇勮噱懅據澽璩籧臄蘧豦遽醵鐻
豩	燹豩豳
豬	橥櫫潴瀦猪藸豬
豸	豸
貈	貈
貝	䟺䢙呗唄垻敗浿狈狽貝贁贝败鋇钡
貞	侦偵帧幀桢楨浈湞祯禎貞贞赪赬遉
負	偩萯蝜負负
貢	唝嗊愩槓碽篢貢贑贡
貪	僋嗿貪贪
貫	惯慣掼摜樌瑻謴貫贯遦鏆
責	㣱㥽㱴䟄䶦债債勣啧嘖嫧帻幘樍渍漬皟碛磧积積箦簀績绩耫襀謮責賾责赜蹟鰿
貴	㚍㿉䙡䜋䯣䰎僓匮匱嘳墤嬇尵愦憒樻櫃殨溃潰瞆瞶穨篑簣繢缋聩聵膭蒉蕢藬蘈貴贵蹪闠阓隤靧鞼頹颓饋馈
買	㵋䁲买卖嘪蕒買賣鷶
費	㵒䊧費费鄪靅
賁	㱵㿎䒈䩿䴅偾僨喷噴坟墳愤憤橨歕濆燌獖羵膹蕡蟦豮豶賁贲轒鐼饙馩鱝黂
賈	價槚檟賈贾
賊	蠈賊贼鱡
賏	甖罂罌譻賏鸎
賓	䎙䚔傧儐嫔嬪宾摈擯槟檳殡殯滨濱獱矉繽缤膑臏薲蠙賓鑌镔顮髌髕鬓鬢
質	䑇劕懫櫍礩質质踬躓鑕锧
賴	㸊䄤䲚嬾懒懶攋濑瀨獭獺癞癩籁籟藾賴赖
贊	㜺䂎䡽䰖儧儹劗囋巑攅攒攢欑濽灒瓒瓚禶穳籫纘缵臜臢襸讃讚賛贊赞趱趲躜躦鄼酂酇鑚鑽钻饡
贙	贙
贛	㔶㯯䤗戆戇灨竷贛赣
赤	㤸䞰䦝䬉捇浾烾焃螫赤赥赦郝
赫	吓嚇爀赫
走	走
足	㹱䎌促哫娖捉浞珿莡趗足鋜齪龊
路	潞璐簬虂路露鷺鹭
身	㑗㧶身銵
躬	匑穷窮藭躬躳
車	厙库庫砗硨裤褲車车
軍	㑮㡓㫎䝍䡣䩵䮝军喗堚恽惲挥揮晕晖暈暉楎浑渾瀈煇珲琿璭瘒皲皸睴緷翚翬荤葷褌諢诨賱軍輝辉运運郓鄆韗顐餫鯶鶤鹍鼲齳
軎	軎
輦	撵攆輦辇鄻
轟	轟轰
轡	轡
辛	㲔㾕垶莘觪辛鋅锌騂骍
辜	䐻嫴橭辜
辟	㠔㱸㵨䌟僻劈噼壁嬖幦廦憵掰擗擘檗澼璧甓癖糪繴臂薜襞譬躃躄辟避鐴鐾闢霹鷿鼊
辠	辠
辡	㦚㸤办瓣辡辦辨辩辫辬辮辯
辥	㔎㜸孼孽嶭櫱糱糵萨薛薩蘖蘗蠥躠辥
辭	辞辤辭
辰	㖘㰮㲀䀼䔚䟴䢅䣅䳲侲唇娠宸屒帪振敐晨桭漘祳脣脤蜃裖賑赈辰辴鋠陙震鷐麎
辱	㦺傉嗕媷搙槈溽縟缛耨蓐褥辱鄏鎒
農	㺜䁸䃩䢉侬儂农哝噥嶩憹擃檂浓濃癑秾穠脓膿襛農辳醲鬞齈
辵	辵
迺	迺
追	㷟䨨䭔塠搥槌磓縋缒膇追鎚
退	腿褪退
送	送
逐	䮱篴蓫逐鱁
造	慥糙艁造
逢	㡝㷭䩼漨篷縫缝蓬蠭逄逢
連	㦁㰈䃛僆嗹摙梿槤涟漣琏璉縺翴莲蓮连連鏈链鰱鲢
進	䗯璡进進
逸	逸
遂	䡵旞檖澻燧璲穟襚譢遂邃鐩隧
道	䆃导導衟道
達	㒓挞撻澾薘跶躂達闥闼鞑韃
遣	䪈䭤繾缱譴谴遣
遺	壝瀢遗遺
邍	邍
邑	䓃䭂䱒俋唈悒挹浥裛邑
邕	㻾嗈噰壅廱拥擁澭灉甕痈癰罋臃邕郺雍雝饔齆
那	哪娜挪那
邦	垹梆綁绑邦
郭	䁨崞廓椁槨漷郭霩鞟鞹
郵	郵
都	嘟都
鄉	䦳乡响曏膷芗薌蚃蠁鄉響飨饗
酉	㾞庮梄槱莤逎酉酒醜
酋	㥢偤媨崷揂楢煪犹猶猷緧莸蕕蝤蟗趥輶遒酋鞧鰌
酓	㜝㱃䳺盦酓
醯	橀醯
釁	亹斖璺舋虋衅釁
釆	釆
采	㥒䐆䰂埰寀彩採棌睬綵菜踩采
里	㦟㽚㾖俚厘哩喱埋娌悝梩榸浬狸理艃荲薶裏裡貍里霾鯉鲤
重	㗢㣫䳯偅动動喠堹尰恸慟懂揰歱湩畽種箽籦緟肿腫董蝩衝褈諥踵重鍾
量	糧量
釐	剺嫠孷斄漦犛釐
金	㕋䘳唫崟嵚嶔廞捦揿撳欽淦菳衔趛金鈙銜錦钦锦顉鵭
錽	鋄錽
鑿	凿糳鑿
長	㙊䂻䗅䠆䩨伥倀帐帳张張怅悵掁枨棖涨漲瓺痮粻胀脹苌萇賬账鋹長长韔餦鼚
門	们們問悶扪捫焖燜聞蔄蕄門閩閿闅门问闷闻闽阌
閃	閃闪
閉	閇閉闭
閏	撋润潤瞤閏閠闰
閐	閐
閑	䔵娴嫻閑闲鷴
閒	㗴㶕僩嫺憪撊橌涧澗痫癇瞯简簡蕑裥襇襉覵覸鐧锏閒間间鬜
閔	悯憫潣燘簢閔闵
閭	䕡榈櫚閭闾
閵	䉮蔺藺躏躙躪轥閵
閻	㶄㿕䌪壛櫩爓讇閻阎
闌	㘓䪍兰幱拦攔斓斕栏欄澜瀾烂爛爤籣糷蘭讕谰躝鑭镧闌阑韊
闖	㶒闖闯
阜	㷆䘀埠阜
阿	䋪啊娿婀痾阿
陟	陟騭骘
除	㾻滁篨蒢除
陳	敶阵陈陣陳
隋	䔺䜏䜐䝐䤻䭉䲊堕堶墮媠嫷嶞惰憜撱椭橢毻瀡隋随隨隳髓鬌
隓	隓
隙	虩隙
隶	㥆䇐䠈叇埭曃棣殔逮隶靆齂
隸	隷隸
隹	隹
隺	㹊㿥䮤傕寉搉榷確篧蒮隺髉鶴鹤
隻	隻
隼	准奞榫準隼
雀	雀
集	㗱㠍䌖䕹囃杂潗磼穕鏶集雜雥
雈	雈
雋	儁寯檇臇鐫镌隽雋
雔	售犨犫讎雔雠
雙	㩳䉶䝄双愯艭雙
雚	䑏䚭䟒䠰劝勸嚾孉懽权權欢歡灌爟獾瓘矔罐虇蠸觀观讙貛酄鑵雚顴颧驩鸛鹳
難	㬮䕼傩儺戁摊攤滩灘瘫癱臡难難
雨	雨
雩	㻬嶀摴樗謣鄠雩
雷	擂癗礌蕾鐳镭雷
需	㹘䞕䨲䰰儒嚅嬬孺懦擩濡獳糯繻羺臑蠕襦譳醹鑐需顬鱬
霍	攉瀖癨矐籗臛藿霍靃
霜	孀霜驦骦鸘
霝	䉹䡼孁棂櫺欞灵爧蘦酃醽霛霝靈麢龗
霸	䨰坝壩欛灞霸
青	㵾䑶䝼倩凊圊婧崝情掅晴棈清猜睛箐篟精綪聙菁蒨蜻請请輤青靓靖靗靘静靚靜鯖鲭鶄鼱
非	㹃䕁䠊䤏䨽䨾䩁俳匪厞啡奜婓婔屝徘悱悲扉排斐棐棑榧猆琲痱篚緋绯翡腓菲蜚裴裶誹诽輩輫辈陫霏非餥馡騑鯡鲱
面	㮌偭勔愐湎緬缅腼蝒面麵
革	㮖䪂緙缂諽革鞂
韋	䙟伟偉围圍媁帏幃愇暐椲湋潿炜煒玮瑋祎禕緯纬苇葦袆褘諱讳违違郼鍏闈闱韋韙韡韦韪
韭	韭韮
韱	㡨䃸䆎䑎䤘孅忏懺攕櫼歼殲瀸签籤纖纤虃襳讖谶鑯韯韱
音	䅧䜾䤃喑嬜愔揞暗歆瘖窨罯腤諳谙闇隌音韽韾黯
頁	頁页
頃	㩩㯋䔛倾傾潁熲穎頃顈顷颍颖
須	䅡嬃盨蕦須须鬚
頤	㺇㺿㼢䇫䱌姬宧弬洍茝頤颐
頪	禷类纇蘱頪類颣
頮	頮
頯	䟸頯
頻	㰋嚬濒瀕蘋頻顰频颦
顥	灏灝顥颢
風	偑堸岚嵐枫楓檒沨渢猦疯瘋葻諷讽風颿飌风
飛	䬠飛飞騛
食	蚀蝕食飤飭飾饬饰
飧	蕵飧
首	䭭首
香	萫香
馬	㾺䣕䧞傌吗嗎妈媽榪玛瑪码碼禡罵蚂螞馬马骂鰢鷌
馭	馭驭
馵	㺛馵
馽	馽
駁	駁驳
驫	驫
骨	㾶䮩䯇䯉䱻嗗尳愲搰榾滑猾磆縎蓇螖顝骨鶻鹘
高	䬘䯨䯪嗃嚎塙壕巐搞敲暠槀槁歊毃毫滈濠瀥熇燺犒皜碻稾稿篙縞缟翯膏蒿薃薧藁藃蠔謞豪鄗鎬镐髇高鰝
髟	髟
鬥	鬥鬪鬬
鬧	閙闹鬧
鬩	㦦阋鬩
鬯	鬯
鬱	欝灪爩鬱
鬲	㣂䃒䈪䙐䩹䮥嗝搹槅滆翮膈蒚虉鎘镉隔鬲
鬳	甗鬳
鬼	㠢㱱䁛䃬䕇䫥䴜傀块塊媿嵬巍廆愧槐溾犩瑰瘣磈聭藱螝褢謉隗餽騩鬼魁魏
鬽	鬽
魚	䁩䰻䱷渔漁魚鱼
魝	蓟薊魝
魯	噜嚕橹櫓穭魯鲁
鮮	䉳廯癣癬藓蘚鮮鲜
鯀	䧰鯀鲧
鰥	㱎䤽瘝鰥鳏
鱻	鱻
鳥	㨶岛島捣搗瞗窎窵茑蔦鳥鸟
鳧	凫鳧鳬
鳴	鳴鸣
鴇	駂鴇鸨
鹵	㔪卤樐滷蓾鏀鹵
鹽	塩盐鹽
鹿	㼾䍡廘摝漉簏蔍螰轆辘鏕騼鹿麓
麀	鏖麀
麃	儦瀌犥皫臕藨鄜鑣镳麃
麗	㿛䕻䚕俪儷孋廲彲曬欐灑矖穲籭纚襹躧逦邐郦酈酾釃驪骊鱺鲡鸝鹂麗
麤	麁麄麤
麥	麥麦
麻	㦄㸏䃺䊳䭩䯢么劘嘛塺嬤嬷懡摩爢犘痲磨糜縻蘑蘼醿靡魔麻麼麽麾
黁	黁
黃	㶇䤑䬝䵃僙彉横橫潢獚璜癀磺簧蟥觵趪鐄鱑黃黄黉黌
黍	黍
黑	㱄䁿䆀䘃嘿嚜墨嫼潶纆黑默
黨	㿩䣣傥儻党戃攩曭欓爣矘讜谠黨
黹	黹
黽	䵴僶憴渑澠繩绳蝇蠅譝鄳鱦黽黾鼆
鼀	竈鼀
鼎	濎薡鼎
鼓	皷瞽臌薣鼓
鼠	癙鼠
鼻	䑄䫁嚊濞襣鼻
齊	䍤䶒䶓䶩侪儕剂劑哜嚌懠挤擠斋櫅济濟癠穧脐臍荠薺虀蛴蠐賷赍跻躋隮霁霽鱭鲚麡齊齋齌齍齎齏齐齑
龍	㰍䆍䪊䮾儱咙嚨垄壟壠宠寵巃庞拢攏昽曨朧栊櫳泷瀧珑瓏矓砻礱竉笼籠聋聾胧茏蘢蠪襱豅贚躘陇隴驡鸗龍龐龓龙
龖	袭襲詟讋龖
龜	阄鬮龜龟
龠	䟑䶳瀹爚禴籥籲蘥讑鑰钥鸙龠
龹	䖭券劵勬帣弮拳桊潫眷絭觠豢韏飬餋齤
𡈼	䦐