音	字	形	註
a	乎	*	諧「ɦa」「hʱa」
e	兮	⿱八?	諧「ɦe」「gʱe」「ʔʱe」「hʱe」「ŋʱe」
ə	矣	77E3	〾大	諧「ɦə」「ʔʱə」「hə」，或音「ɦlə」
ʔa	於	〾烏	「烏」聲
ʔai	奇	⿱大可	「可」聲，又音「kai」
ʔam	奄	?
ʔan	焉	⿱正*
ʔanˀ	匽妟	⿷匚妟	「妟=⿱日女」聲
ʔat	曷	⿹刀亡	「匄」聲，又音「kat」
ʔau	夭	〾大
ʔaŋ	央	〾大
ʔek	益	⿱水皿
ʔem	厭猒	⿸厂猒	「猒=⿰⿱口肉犬」聲，又音「ʔep」
ʔep	厭猒	⿸厂猒	「猒=⿰⿱口肉犬」聲，又音「ʔem」
ʔeu	要	⿻〾大⺽
ʔeŋ	嬰賏	⿱賏女	「賏=⿰貝貝」聲
ʔi	伊	⿰人尹	少字
ʔin	因	⿴囗大
ʔin	垔	⿱?土
ʔinʰ	印	⿰爪卩	少字
ʔit	一	*	少字
ʔit	壹	⿴壺吉	「吉」聲
ʔiu	幺幼幽	*
ʔo	區	⿷匚品	又音「kʰo」
ʔon	冤	⿱冖兔	或音「ʔʷan」「ʔʷen」
ʔon	夗宛	?	或音「ʔʷan」
ʔoŋ	邕雍	⿱川邑
ʔraŋ	英	⿱艸央	「央」聲
ʔreuk	約	⿰糸勺	「勺」聲
ʔrit	乙	*	或音「ʔrət」
ʔrət	乙	*	或音「ʔrit」
ʔu	憂㥑	⿱㥑夊	「㥑=⿱頁心」聲
ʔui	威	⿹戌女	古文作「⿹戈女」
ʔui	畏	〾鬼	與「鬼」轉注
ʔuk	奧奥	⿳宀釆廾
ʔun	𥁕昷	⿱?皿
ʔut	尉	⿰?又
ʔut	鬱	?
ʔə	殹医	⿰医殳	「医=⿷匚矢」聲，又音「'ʱi」
ʔəi	衣	*
ʔək	意	⿱〾言心
ʔəm	侌	⿱今云	「今」聲
ʔəm	酓	⿱今西	「今」聲，諧「ʔim」「ʔem」「ʔam」
ʔəm	音	〾言
ʔəm	弇	⿱合廾	「合」聲，諧「ʔram」
ʔən	殷	⿰↔身殳	少字，省作「㐆=↔身」
ʔənˀ	㥯	⿱⿳爪工又心	「⿳爪工又」聲
ʔəp	邑	⿱囗卩
ʔətʰ	愛㤅	⿱爪㤅	「㤅=⿱旡心」聲
ʔəŋ	䧹	〾隹
ʔʱa	烏	*
ʔʱa	亞	*
ʔʱai	阿	⿰阜可	「可」聲
ʔʱak	惡	⿱亞心	「亞」聲
ʔʱan	安	⿱宀女
ʔʱen	燕	*
ʔʱi	殹医	⿰医殳	「医=⿷匚矢」聲，又音「'ə」
ʔʱloŋ	翁	⿱公羽	「公」聲
ʔʱok	屋	⿱?室
ʔʱra	丫	*	后起
ʔʱranʰ	晏	⿱日安	「安」聲
ʔʱrek	厄戹	*
ʔʱruk	學!	⿱⿴⺽爻六	即「學」上半結構，又音「kʱruk」
ʔʱu	麀鏖	⿱鹿牝
ʔʱə	毐	⿱士毋	或音「ʔʱəi」
ʔʱəi	毐	⿱士毋	或音「ʔʱə」
ʔʱən	恩	⿱因心	「因」聲
ʔʷan	冤	⿱冖兔	或音「ʔon」「ʔʷen」
ʔʷan	夗宛	?	或音「ʔon」
ʔʷe	圭	*	又音「kʷe」「wʱe」「hʷe」
ʔʷen	冤	⿱冖兔	或音「ʔʷan」「ʔon」
ʔʷin	淵!	⿴?水	即「淵」右半結構
ɦaŋ	行	*	或音「gʱaŋ」
ɦep	劦	⿱力⿰力力	又音「rʱepʰ」
ɦlaʰ	互	〾牙	「牙」聲
ɦlat	舌	*	獨字
ɦlau	号	⿱口?	又音「lʰʱau」、「hrau」
ɦli	示	*	又音「gli」
ɦlit	實	⿱宀貫	獨字
ɦlun	盾	*	又音「slun」「lʱunˀ」
ɦlut	术朮	*
ɦlək	食	⿱亼皀
ɦlǝŋ	乗乘	⿳大舛木
ɦo	侯矦	⿰人⿸厂矢	「⿸厂矢」聲，或音「gʱo」
ɦoˀ	厚	⿸厂*	獨字，或音「gʱoʔ」
ɦoˀ	後	⿰辵幺	獨字，或音「gʱoʔ」
ɦraˀ	下	*	少字，或音「gʱraʔ」
ɦraˀ	夏	⿱頁夊	少字，或音「gʱraʔ」
ɦraŋˀ	杏	⿱木口	少字，或音「gʱraŋʔ」
ɦren	閑	⿵門木	少字，或音「gʱren」
ɦreŋˀ	幸	⿱夭屰	少字，或音「gʱreŋʔ」
ɦǝm	函	⿴?至	或音「gʱǝm」
bam	凡	*	含「風」
ban	煩	⿰火頁	少字
ban	棥樊	⿴林爻
ban	緐繁	⿰每糸
bap	乏	〾正	又音「pam」
bat	伐	⿰人戈
bat	罰	⿰⿱网言刀	少字
batʰ	吠	⿰口犬	少字
bin	頻	⿻⿰步水
boŋ	夆逢	⿱夊丰	「丰」聲
breŋ	平	*	又音「pʰreŋ」
brək	備!	⿱至用	即「備」右半結構
bu	孚	⿱爪子	又音「pʰo」
buˀ	阜	*
bə	咅	⿱不口	「不」聲
bǝˀ	負	⿱人貝
bǝˀ	婦	⿰女帚	少字
bək	伏	⿰人犬
bək	服	⿰?⿱卩又
bən	盆	⿱分皿	「分」聲
bən	焚	⿱林火	獨字
bʱaʰ	步	⿱止↔止	少字
bʱeŋˀ	並	⿰立立	少字，諧聲混亂
bʱraŋ	彭	⿰壴彡
bʱəʰ	佩珮	⿰人⿱凡巾	少字
ca	且	*
cak	昔	⿱〾川日	又音「sak」
cam	斬	⿰車斤
can	戔	⿱戈戈	又音「cen」
cap	疌	⿻又矢
cap	妾	⿱辛女	又音「cep」
cau	喿	⿱品木	三等少字
caŋ	爿將	½木
ce	此	⿰止𠤎
cek	責	⿱朿貝	「朿」聲
cek	脊	⿱*肉	「脊」上半部分結構是爲聲首，少字
cem	韱㦰	⿹㦰韭	「㦰=⿰从戈」聲
cem	尖	⿱小大	後起獨字，同「鑯」
cen	前歬	⿰歬刀	「歬=⿱止舟」聲
cen	戔	⿱戈戈	又音「can」
cep	妾	⿱辛女	又音「cap」
cet	截	⿰⿱?隹戈
cet	祭	⿱⿰肉又示
ceu	焦	⿱隹火
ceuk	爵	⿰*又
ceuk	雀	⿱少隹	獨字，「小」聲
ceŋ	青	⿱生丹/⿱生井	「生」聲
ceŋ	晶	⿱日⿰日日	獨字
ceŋˀ	井	*
ci	次	⿰二欠
ci	齊	⿲***
ci	𠂔	*
cin	秦	⿳午廾禾
cin	津	⿰水聿	與「盡」轉注，少字
cin	進	⿰辵隹	少字
cinʰ	晉臸	⿱臸日	「臸=⿰至至」聲，又音「cenʔ」
cik	即節	⿰皀卩
ciu	秋	⿰禾火
ciuk	戚	〾戈
co	取	⿰耳又
cok	足	〾止
con	雋	⿱隹弓	諧「coi」「cun」「cui」「cuin」
cot	絕脆	⿰幺刀
coŋ	从從	⿰人人
cra	虘查	⿸虍且	「且」聲
crau	巢	⿱*木
craŋ	壯	⿰爿士	「爿」聲
cren	孱孨	⿸尸孨	「孨=⿱子⿰子子」聲
crep	臿	⿱午臼
cret	札	⿰木乚
creŋ	爭	⿳爪一又
cro	芻	⿻又艸
crǝ	甾	*
crəʰ	事	〾史	「史」聲
crǝk	則	⿰鼎刀	又音「cʱǝk」
crǝk	夨仄	〾大
cu	酉酋	*	又音「lu」
cuk	就	⿰京尤
cun	尊	⿱酋又
cut	卒	⿻衣一	又音「sut」
cǝ	子	*
cǝ	才𢦏哉	*
cǝ	茲兹	⿱艸〾絲	「絲」聲
cǝˀ	宰梓	⿱宀辛
cǝm	侵!	⿱帚又	即「侵」右半部分結構
cǝm	朁兓兂	⿱兓曰	「兂=〾女」聲
cǝp	咠	⿱口耳
cǝp	集	⿱隹木
cǝŋ	曾	⿱*曰	又音「sʱǝŋ」
cʱai	左差𠂇	⿸𠂇工	「𠂇」聲，「差」諧聲混亂
cʱak	乍	*
cʱanˀ	贊	⿱⿰夫夫貝	又音「cʱon」
cʱat	蔡	⿱艸祭	「祭」聲
cʱaŋ	臧	⿲爿臣戈	「爿」聲
cʱaŋ	葬	⿴茻死	少字
cʱen	千	⿻人一	或音「cʱin」
cʱen	薦	⿱艸廌	或音「cʱǝn」
cʱin	千	⿻人一	或音「cʱen」
cʱoˀ	走	⿱夭止	獨字
cʱoʰ	奏	⿴廾木
cʱoi	坐	⿱从土
cʱok	族	⿸㫃矢
cʱon	贊	⿱⿰夫夫貝	又音「cʱanˀ」
cʱot	最	⿱冃取	「取」聲
cʱoŋ	囪悤㚇	*
cʱruˀ	爪找	〾又	少字
cʱu	曹㯥	⿱㯥曰	「㯥=⿰東東」聲
cʱuˀ	蚤㕚	⿱㕚虫	「㕚=〾又」聲，又音「sʱu」
cʱuˀ	早	⿱日甲
cʱuˀ	棗	⿱朿朿	獨字
cʱuʰ	灶	⿰火土	後起獨字，同「竈」
cʱuŋ	宗	⿱宀示
cʱǝ	災灾	⿱〾川火	少字，或音「cʱǝi」
cʱǝʰ	再	½冓	少字，或音「cʱǝiʰ」
cʱǝi	災灾	⿱〾川火	少字，或音「cʱǝ」
cʱǝiʰ	再	½冓	少字，或音「cʱǝʰ」
cʱǝk	則	⿰鼎刀	又音「crǝk」
cʱǝn	薦	⿱艸廌	或音「cʱen」
cʱǝp	雜	⿰衣集	「集」聲
cʱǝp	帀匝	↺之	少字
cʰan	䙴	?	或音「cʰen」，又音「san」或「sen」
cʰaŋ	倉	⿴合戶
cʰek	朿	〾木
cʰen	䙴	?	或音「cʰan」，又音「san」或「sen」
cʰeu	少	〾小	「小」聲，又音「meu」
cʰi	妻	⿰又⿱?女
cʰin	亲親	⿱辛木	「辛」聲
cʰit	七切	*
cʰit	桼	⿱木水
cʰon	全	⿱入玉	又音「zon」
cʰon	泉	⿱*水	又音「zon」
cʰonˀ	算	⿱竹具	又音「sonˀ」
cʰot	毳	⿱毛⿰毛毛
cʰra	初	⿰衣刀	獨字
cʰraˀ	楚	⿱林疋	「疋」聲
cʰram	毚	⿱兔兔	又音「zram」
cʰraŋˀ	爽	⿻大⿰口口	又音「sraŋˀ」
cʰrek	冊	*
cʰrəm	參	⿱晶彡	又音「sʱəm」「cʰrəm」「srəm」
cʰutʰ	翠	⿱羽卒	「卒」聲
cʰʱan	粲餐	⿱⿰歺又米	「⿰歺又」聲
cʰʱonʰ	竄	⿱穴鼠	少字
cʰʱrai	叉	⿴又丶	或音「cʰʱre」
cʰʱuˀ	艸	⿰屮屮	獨字
cʰʱun	寸	〾又
cʰʱǝˀ	采	⿱爪木
cʰʱəm	參	⿱晶彡	又音「sʱəm」「cʰrəm」「srəm」
daʰ	署	⿱网者	「者」聲
daiʰ	筮	⿱竹巫	或音「deiʰ」
daŋ	尚	⿳八冂口
daŋˀ	上	*	獨字
deiʰ	筮	⿱竹巫	或音「daiʰ」
dep	涉	⿻步乙	少字
deŋ	成	⿰丁戈	「丁」聲
do	殳	*
do	尌	⿱⿰木又豆	「豆」聲
dok	蜀	⿱見虫
dran	廛	⿸广⿱?土	或音「dren」「lran」「lren」
draŋˀ	丈	⿱十又	或音「lraŋˀ」
dreˀ	廌	*	獨字	或音「lreˀ」
dreˀ	豸	*	獨字	或音「lreˀ」
dren	廛	⿸广⿱?土	或音「dran」「lran」「lren」
dret	徹!	*	即「徹」右側結構，又音「tʰret」，或音「lret」
dreŋʰ	鄭	⿰奠邑	少字，「奠」聲
drin	陳陣	?	少字，或音「lrin」
drin	塵尘	⿱鹿土	獨字，或音「drǝn」「lrin」「lrǝn」
dro	廚	⿸广尌	「尌」聲
drən	塵尘	⿱鹿土	獨字，或音「drin」「lrin」「lrǝn」
du	雔售	⿰隹隹	少字，或音「tʰu」
duk	孰	⿰享丮
dʱa	屠	⿸尸者	「者」聲
dʱa	圖	⿴囗啚	獨字，或音「lʱa」
dʱak	度	⿸石又	「石」聲
dʱatʰ	大太泰	*	或音「lʱatʰ」
dʱauʰ	盜	⿱㳄皿	獨字，或音「lʱauʰ」
dʱaŋ	堂棠	⿱尚土	「尚」聲
dʱaŋʰ	宕	⿱宀石	獨字，「石」聲
dʱek	狄	⿰犬火	或音「lʱek」
dʱem	甜恬	⿰舌甘	或音「lʱem」
dʱep	疊	⿱⿱日⿰日日宜	少字，或音「lʱep」
dʱeŋ	亭	⿱高丁	「丁」聲
dʱeŋʰ	定	⿱宀正	「丁」聲
dʱi	弟	⿻必己	或音「lʱi」
dʱin	田	*	或音「lʱin」
dʱinʰ	奠	⿱酉丌	少字
dʱot	奪	⿳衣隹又	獨字，或音「lʱot」
dʱoŋˀ	動	⿰重力
dʱu	匋	⿴勹缶	或音「lʱu」
dʱuk	毒	⿱屮毐	或音「lʱuk」
dʱuŋ	彤	⿰丹彡	少字，或音「lʱuŋ」
dʱǝm	曇	⿱日⿱雨云	少字，或音「lʱǝm」
dʱəp	沓	⿱水曰	或音「lʱəp」
ga	渠	⿱⿰水巨木	「巨」聲
gaˀ	巨	*	諧「kaˀ」
ge	氏	*	又音「te」
gin	臣	*	少字
gli	示	*	又音「ɦli」
gra	豦	⿸虍豕
granˀ	件	⿰人牛	後起獨字，或音「grenˀ」
grat	桀	?	或音「gret」
grat	杰	?	後起，獨字，或音「gret」
grak	劇	⿰豦刀	「豦」聲
grenˀ	件	⿰人牛	後起獨字，或音「granˀ」
gret	桀	?	或音「grat」
gret	杰	?	後起，獨字，或音「grat」
gu	求	⿱入水
guˀ	臼	*
gǝm	禽	⿱今离	「今」聲
gʱa	胡	⿰古肉	「古」聲
gʱai	賀	⿱加貝	「加」聲
gʱaŋ	行	*	或音「ɦaŋ」
gʱet	頁	*	獨字，或音「gʱit」
gʱeŋ	刑形邢鈃㼛	⿰*刀	「刑」左側結構爲聲首，存疑
gʱit	頁	*	獨字，或音「gʱet」
gʱo	侯矦	⿰人⿸厂矢	「⿸厂矢」聲，或音「ɦo」
gʱoˀ	厚	⿸厂*	獨字，或音「ɦoˀ」
gʱoˀ	後	⿰辵幺	獨字，或音「ɦoˀ」
gʱraˀ	下	*	少字，或音「ɦraˀ」
gʱraˀ	夏	⿱頁夊	少字，或音「ɦraˀ」
gʱrau	爻肴	*
gʱraŋˀ	杏	⿱木口	少字，或音「ɦraŋˀ」
gʱren	閑	⿵門木	少字，或音「ɦren」
gʱreŋˀ	幸	⿱夭屰	少字，或音「ɦreŋˀ」
gʱǝm	函	⿴?至	或音「ɦǝm」
gʱǝm	含	⿱今口	「今」聲
hai	䖒戲	⿱虍豆
hanˀ	憲	⿱害心
haŋ	亯亨享	*
haŋ	鄉	⿲卩皀卩
haŋ	香	⿱禾甘	少字
hep	脅	⿱劦肉	「劦」聲
hiu	收	⿰丩攴	「丩」聲
hlaŋˀ	向	⿱宀口	又音「lʰaŋʰ」
hlun	川	*	「川」字音「kʰlon」，諧「hlunʰ」「ɦlun」等音
hoŋ	凶兇匈	⿶凵?
hra	虛	⿱虍丘	「虍」聲，又音「kʰra」
hramˀ	僉	⿳亼⿰口口⿰人人	又音「kramˀ」「ŋramˀ」「ramˀ」
hroiˀ	毀	⿰?殳	或音「hʷraiˀ」
hruk	畜	⿱幺田	又音「lʰruk」
hu	休	⿰人木
hui	虫	*	又音「luŋ」
hun	熏	⿱〾東火
hə	喜	⿱壴口
həi	希	⿱爻巾
hǝn	斤	*	又音「kən」「ŋən」
hǝp	翕	⿱合羽	「合」聲
hǝt	乞	〾气	「kǝt」「ŋǝt」
həŋ	興	⿴舁同
hʱa	虖	⿸虍乎	「虍」聲「乎」聲
hʱai	可	⿹*口	又音「kʱai」
hʱak	㕡	⿰⿱歹谷又
hʱe	奚	⿳爪幺大	又音「kʱe」
hʱla	虎虍	*
hʱlanˀ	𦰩	⿱口〾大	又音「nan」「nʱai」
hʱoˀ	吼	⿰口孔	獨字，「孔」聲
hʱrak	赫	⿰赤赤	「赤」聲
hʱrau	号	⿱口?	又音「lʱʰau」「ɦlau」
hʱru	孝	⿱耂子	與「老」「考」轉注
hʱuˀ	好	⿰女子	獨字
hʱuiˀ	卉	⿱屮⿰屮屮
hʱəm	今	⿱亼一	又音「kəm」「ŋəm」
hʱǝm	咸	⿹戌口	「kʱǝm」「klǝm」「ŋʱrǝm」
hʱǝp	合	⿱亼口	又音「kǝp」
hʷak	矍	⿳䀠隹又	又音「kuak」
hʷaŋ	兄	⿱口卩
hʷe	圭	*	又音「kʷe」「wʱe」「ʔʷe」
hʷit	血	*
hʷraiˀ	毀	⿰?殳	或音「hroiˀ」
hʷʱak	霍	⿱雨隹
hʷʱek	砉	⿱圭石	「圭」聲
ka	居	⿸尸古	「古」聲
ka	車	*	或音「kia」
kai	奇	⿱大可	「可」聲，又音「'ai」
kai	羈	⿱网⿰革馬	獨字
kak	卻!	⿱仌口	即「卻」左側結構
kam	甘	*	又音「kəm」
kan	寒	⿱宀⿴茻人	「仌」常省
kan	干旱	*	三等少字
kan	建	⿺彳聿
kap	盍劫	⿱*皿
kat	丐匄曷	⿹刀亡	「曷」又音「'at」
kau	喬	⿱*高	「高」聲
kaŋ	强強	⿰弓⿱口虫
kaŋ	畺	⿱田田
ke	只	⿱口八
ke	支	⿱个又
ket	丯㓞契	*
keŋ	巠	*
ki	旨	⿱匕曰
kip	十	*
kit	吉	⿱士口
kiu	丩	*	又音「ku」
kloŋ	公	⿱八?
klut	出	⿶凵止
klǝm	咸	⿹戌口	「kʱǝm」「hʱǝm」「ŋʱrǝm」
ko	句	⿹丩口	「丩」聲
ko	具	⿱鼎廾	又音「koˀ」「kok」
kok	局	⿸尸句	「句」聲
kon	雈雚	*	或音「kʷan」
kon	龹卷	⿱釆廾	或音「kʷan」「kʷen」
kot	欮厥	⿰屰欠	或音「kʷat」「kʷet」
koŋ	巩	⿰工丮	「工」聲
koŋ	廾共	⿰又又
krak	丮	⿻卩⿱手手	少字
krak	戟	⿸倝戈	少字
kramˀ	僉	⿳亼⿰口口⿰人人	又音「hramˀ」「ŋramˀ」「ramˀ」
kran	虔	⿱虍文
krat	孑	〾子	少字，或音「kret」
kraŋ	京景	⿳亠口?	又音「raŋ」
kraŋˀ	竞竟競	⿱言大
kret	孑	〾子	少字，或音「krat」
kreŋ	敬	⿰茍攴
kri	几	*	或音「krǝi」
krip	皀	*
krit	屆	⿸尸凷	獨字，「凷」聲
kriu	翏	*	又音「riu」「mriu」
krot	孓	〾子	獨字
krun	囷	⿴囗禾
krǝi	几	*	或音「kri」
krǝiʰ	冀	⿱?異	少字
krəm	禁	⿱林示	「林」聲
krǝn	巾	*	少字
krǝp	及	⿱人又
krǝŋ	兢	〾競
ku	九	*
ku	咎	⿰各人
ku	簋𣪘	⿳竹皀皿	少字
kuˀ	韭	*	獨字
kui	㱕歸	⿰止帚
kui	鬼	*
kui	貴	⿱?貝
kui	龜	*	又音「kʷə」
kuk	匊	⿴勹米
kuk	𦥑	⿰又又	少字
kut	屈	⿸尸出	「出」聲
kuŋ	宫	⿳宀囗囗
kǝ	其丌亓	*
kǝi	幾	⿱⿰幺幺戍
kǝi	豈	⿱?豆	又音「ŋǝi」
kǝtʰ	既旡	⿰皀旡	「旡=↔欠」聲
kǝk	亟	⿴二⿲人口又
kǝk	棘	⿰朿朿
kək	茍	⿱羊卩	獨字
kəm	今	⿱亼一	又音「hʱəm」「ŋəm」
kǝm	金	*
kǝn	堇	⿱𦰩火
kǝn	斤	*	又音「ŋən」「hən」
kǝn	筋	⿱竹⿰肉刀
kǝp	合	⿱亼口	又音「hʱǝp」
kǝt	乞	〾气	「hǝt」「ŋǝt」
kǝtʰ	气	*
kǝˀ	己	*
kʷa	䀠	⿰目目
kʷak	矍	⿳䀠隹又	又音「hʷak」
kʷan	龹卷	⿱釆廾	或音「kon」「kʷen」
kʷat	欮厥	⿰屰欠	或音「kot」「kʷet」
kʷe	圭	*	又音「ʔʷe」「wʱe」「hʷe」
kʷe	規	⿰?見
kʷen	龹卷	⿱釆廾	或音「kʷan」「kon」
kʷet	夬	⿻又〇
kʷet	欮厥	⿰屰欠	或音「kʷat」「kot」
kʷeŋ	夐	⿳角目攴	又音「kʷin」
kʷiʰ	季	⿱禾子	少字
kʷin	夐	⿳角目攴	又音「kʷeŋ」
kʷi	癸	*
kʷə	龜	*	又音「kui」
kʷǝˀ	久	*
kʷǝŋ	弓	*
kʱa	古辜	⿱甲口
kʱaʰ	固	⿴囗古	「古」聲
kʱai	可哥	⿹*口	又音「hai」
kʱaiʰ	个	½竹	讀音后起附會，形似「介」而用以記音，同「個」
kʱamˀ	敢	⿰⿱爪豕又
kʱan	倝	⿱㫃旦
kʱat	害	*
kʱau	高	*	又音「hʱau」
kʱauk	隺	⿱宀隹
kʱauˀ	夰奡昊	⿱?大
kʱaŋ	亢	⿵大一
kʱaŋ	岡	⿱网山
kʱaˀ	夃股	*	少字
kʱaˀ	蠱	⿱蟲皿	獨字
kʱaˀ	襾賈	*
kʱe	奚	⿳爪幺大	又音「hʱe」
kʱeʰ	系	⿱爪糸	少字
kʱeʰ	㡭繼	⿱⿺𠃊⿰幺幺⿺𠃊⿰幺幺	少字
kʱek	毄	⿰軎殳
kʱen	肩	⿱*肉
kʱen	幵	⿰干干	又音「ŋʱen」
kʱen	艮	*	又音「ŋen」
kʱenˀ	見	⿱目卩	又音「ŋʱenʰ」
kʱenˀ	繭	⿻?⿰糸虫	獨字
kʱep	夾	⿻大从	三等少字
kʱet	絜	⿱㓞糸	「㓞」聲
kʱet	魝	⿰魚刀	少字，或音「kʱit」
kʱeu	梟	⿱鳥木	少字
kʱeu	敫	⿰?攴	三等少字，又音「kʱeuk」
kʱeuk	敫	⿰?攴	三等少字，又音「kʱeu」
kʱi	卟乩	⿰口卜	獨字
kʱit	魝	⿰魚刀	少字，或音「kʱet」
kʱlak	各	⿱夊凵	又音「rʱak」
kʱlau	羔	⿱羊火	又音「lau」
kʱlaŋ	康	〾庚	「庚」聲
kʱlem	兼	⿻又⿰禾禾	又音「rem」
kʱloi	戈	*	或音「kʷʱlai」，「戈」聲「鳶」字音「glon」或「gʷlan」
kʱlok	谷	*	又音「lok」
kʱlun	君	⿱尹口	「尹」聲
kʱlunˀ	袞	⿴衣㕣	少字，「㕣」聲
kʱləmˀ	臽	⿱人*
kʱo	冓	*	又音「kʱroŋˀ」，或音「kʱro」
kʱoˀ	后	⿱?口	結構與「司」對稱
kʱoi	冎咼	*	或音「kʷʱai」
kʱoi	果	⿱*木	或音「kʷʱai」
kʱok	㱿	⿰*殳
kʱok	角	*
kʱon	毌貫	*	或音「kʷʱan」
kʱon	官	⿱宀𠂤	或音「kʷʱan」
kʱonˀ	盥	⿱⿴⺽水皿	獨字，或音「kʷʱanˀ」
kʱot	咶!	⿱?口	即「咶」右半結構，或音「kʷʱat」「wʱat」
kʱot	會	⿴合?	或音「kʷʱat」「wʱat」
kʱoŋ	工	*
kʱra	家	⿱宀豕
kʱra	叚	⿰石⿱爪又
kʱrai	加	⿰力口
kʱram	監	⿱⿰臣人皿	又音「rʱamˀ」
kʱran	閒間	⿵門月	又音「kʱren」
kʱrap	甲	*
kʱrau	教敎	⿰⿱爻子攴	「爻」聲
kʱraŋ	更	⿱丙攴
kʱraŋ	庚	*	少字
kʱraŋ	羹	⿱羔美	少字
kʱreˀ	解	⿰角⿱刀牛
kʱrek	鬲	*	又音「rʱek」
kʱren	閒間	⿵門月	又音「kʱran」
kʱrenˀ	柬	*	又音「rʱenʰ」
kʱret	介	⿻人⿰丶丶
kʱret	戛	⿱頁戈	「頁」聲，少字，或音「kʱrit」
kʱreu	交	〾大
kʱreŋˀ	耿	?	少字
kʱri	皆	⿱从曰	或音「kʱrǝi」
kʱrit	戛	⿱頁戈	「頁」聲，少字，或音「kʱret」
kʱron	關	⿵門⿱⿰幺幺丱	獨字，「聯」聲
kʱronʰ	串	*	或音「kʷʱranʰ」
kʱroŋˀ	冓	*	又音「kʱo」
kʱruk	學!	⿱⿴⺽爻六	即「學」上半結構，又音「ʔʱruk」
kʱruŋ	夅	⿱夊㐄	又音「ruŋ」
kʱrǝi	皆	⿱从曰	或音「kʱri」
kʱrǝk	革	*
kʱu	皋	*
kʱui	褱	⿴衣眔	又音「kʱun」
kʱuk	告	⿱牛口
kʱun	昆	*
kʱun	眔褱	⿱目水	又音「ləp」「kʱui」
kʱut	骨	⿱冎肉
kʱǝ	亥	*	諧「kʱǝk」
kʱǝm	咸	⿹戌口	「hʱǝm」「klǝm」「ŋʱrǝm」
kʱǝmˀ	感	⿱咸心	「咸」聲
kʱǝmˀ	贛	⿰章丮
kʱək	戒	⿱戈廾
kʱəŋ	亙	⿴二月
kʷʱa	瓜	*
kʷʱaˀ	鼓	9F13	⿰壴攴
kʷʱai	冎咼	*	或音「kʱoi」
kʷʱai	果	⿱*木	或音「kʱoi」
kʷʱak	郭	⿰⿴京⿴囗囗邑
kʷʱan	毌貫	*	或音「kʱon」
kʷʱan	官	⿱宀𠂤	或音「kʱon」
kʷʱanˀ	盥	⿱⿴⺽水皿	獨字，或音「kʱonˀ」
kʷʱat	咶!	⿱?口	即「咶」右半結構，或音「kʱot」「wʱat」
kʷʱat	會	⿴合?	或音「kʱot」「wʱat」
kʷʱaŋ	光	⿱火人
kʷʱek	狊	⿱目犬
kʷʱenˀ	犬	*	或音「kʷʱinˀ」
kʷʱeŋ	冋冏	⿵冂口
kʷʱinˀ	犬	*	或音「kʷʱenˀ」
kʷʱlai	戈	*	或音「kʱloi」
kʷʱraˀ	寡	⿳宀頁人	獨字
kʷʱranʰ	串	*	或音「kʱronʰ」
kʷʱri	乖	⿻?北
kʷʰʱanˀ	款	⿰?欠	或音「kʰʱonˀ」
kʰa	去	⿱大凵
kʰamˀ	欠	〾人
kʰenˀ	遣	⿰辵⿱⺽𠂤	「⿱⺽𠂤」聲
kʰeˀ	企	⿱人止	獨字
kʰiʰ	弃棄	⿱𠫓廾	獨字
kʰlaˀ	處	⿱虍⿰夊几	「虍」聲
kʰlak	赤	⿱大火
kʰlaŋ	羌	⿱羊人	「羊」聲
kʰleŋ	殸	⿰⿱幺石殳	諧「hleŋ」
kʰluˀ	臭	⿱自犬	諧「hluˀ」
kʰo	區	⿷匚品	又音「ʔo」
kʰok	曲	*
kʰra	虛	⿱虍丘	「虍」聲，又音「hra」
kʰrak	隙!	⿳小日小	少字，即「隙」右側結構
kʰrau	橇撬	⿰木毳	後起，少字，或音「kʰreu」
kʰraŋ	卿	〾鄉	獨字，「鄉」聲
kʰraŋʰ	慶	⿳鹿心夊	少字
kʰreu	橇撬	⿰木毳	後起，少字，或音「kʰrau」
kʰriʰ	器	⿳吅犬吅	獨字，或音「kʰrəiʰ」
kʰrəiʰ	器	⿳吅犬吅	獨字，或音「kʰriʰ」
kʰuə	丘	*
kʰʱan	看	⿱㫃目	獨字，「㫃」聲
kʰʱanˀ	侃	⿰人⿱口川	獨字
kʰʱeˀ	啓!	⿰戶攴	即「啓」上方結構
kʰʱen	牽	⿱⿻玄冂牛	或音「kʰʱin」
kʰʱin	牽	⿱⿻玄冂牛	或音「kʰʱen」
kʰʱluˀ	考	⿱耂丂	「丂」聲，與「老」轉注
kʰʱoˀ	口	*
kʰʱoʰ	寇	⿱宀⿰元攴
kʰʱok	哭	⿱吅〾大	獨字
kʰʱonˀ	款	⿰?欠	或音「kʷʰʱanˀ」
kʰʱoŋ	空	⿱穴工	「工」聲
kʰʱoŋˀ	孔	〾子	獨字
kʰʱruˀ	丂	*	諧「hruˀ」「kʰʱluˀ」
kʰʱun	坤	⿰土申	獨字
kʰʱunˀ	困	⿴囗木
kʰʱutʰ	凷	⿶凵土	少字
kʰʱək	克	*
kʰʱəŋˀ	肯肎	⿱冎肉	獨字
la	與	⿴舁与	「与」聲「舁」聲
la	舁	⿱⺽廾
la	予	*	與「呂」一字分化
la	余	*
la	与	〾牙	「牙」聲，分化
lai	它	*
lai	也施	⿱口乙	諧「le」「liaiˀ」
lai	多	⿱肉肉
lak	亦夜	⿻大⿰丶丶	諧「liakʰ」
lak	睪	⿱目㚔
lam	炎	⿱火火
lam	閻	⿵門臽	「臽」聲
lam	鹽	⿴監鹵	「監」聲
lan	延	⿺彳止
lanˀ	衍	⿴行水	少字
lap	傝!	⿱冃羽	即「傝」右側結構
latʰ	曳	⿻⺽人	或音「letʰ」
latʰ	裔	⿳衣內口	少字，或音「letʰ」
lau	兆	⿴北乙	又音「leu」
lau	羔	⿱羊火	又音「kʱlau」
lauk	樂	⿱⿲幺白幺木	或音「leuk」，又音「rʱauk」「rʱeuk」
lauk	龠	⿱亼*	或音「leuk」
laŋ	昜	⿱日丂
laŋ	羊	*
le	虒	*
letʰ	曳	⿻⺽人	或音「latʰ」
letʰ	裔	⿳衣內口	少字，或音「latʰ」
lek	易	*
lep	世枼葉	*
leu	䍃	⿱肉缶	又音「lu」
leu	兆	⿴北乙	又音「lau」
leuk	翟	⿱羽隹
leuk	樂	⿱⿲幺白幺木	或音「lauk」，又音「rʱauk」「rʱeuk」
leuk	龠	⿱亼*	或音「lauk」
leŋ	𡈼呈	⿱人土
leŋ	嬴!	*	即「嬴」除「女」以外結構，又音「roi」
leŋ	盈	⿱?皿
li	夷	⿻矢己
li	尸屖	*
liʰ	㣇肄	*	又音「siʰ」
lia	邪耶	⿰牙邑	「牙」聲，諧「slia」
liak	射	⿰⿻弓矢又	⿰弓矢	諧「siakʰ」
lin	申	*
linˀ	引	〾弓
linʰ	胤	⿻⿱幺肉八
lit	失	⿱?人
lit	逸	⿰辵兔	少字
lit	戜	⿰呈戈	少字，「呈」聲
liu	由	*	又音「liuk」
liu	攸	⿰人攴	又音「liuk」「siu」
liuk	攸	⿰人攴	又音「liu」「siu」
liuk	由	*	又音「liu」
lo	臾	⿻人廾
lo	俞	⿰凡?
loi	隋	⿰阜⿱⿸又土肉	「⿰阜⿸又土」聲，又音「sloi」「soi」
lok	𧶠	⿱⿳屮六目貝	「六」聲
lok	谷	*	又音「kʱlok」
lon	㕣	⿱八口
lon	彖	*	與「豚」轉注
lot	兌兑	⿳八口人
loŋ	用同甬庸	*
loŋ	容	⿱宀公	「公」聲
lran	廛	⿸广⿱?土	或音「lren」「dran」「dren」
lrauˀ	肇	⿱⿰戶戈聿	或音「lreuˀ」
lran	廛	⿸广⿱?土	或音「lren」「dran」「dren」
lraŋˀ	丈	⿱十又	或音「draŋˀ」
lreˀ	廌	*	獨字	或音「dreˀ」
lreˀ	豸	*	獨字	或音「dreˀ」
lret	徹!	*	即「徹」右側結構，或音「tʰret」「dret」
lreuˀ	肇	⿱⿰戶戈聿	或音「lrauˀ」
lrin	陳陣	?	少字，或音「drin」
lrin	塵尘	⿱鹿土	獨字，或音「lrǝn」「drin」「drǝn」
lriuk	逐	⿰辵豕
lrəm	朕	⿰舟⿱丨廾	又音「ləŋ」
lrən	塵尘	⿱鹿土	獨字，或音「lrin」「drin」「drǝn」
lu	斿	⿸㫃子
lu	卣	*	少字
lu	舀	⿱爪臼
lu	䍃	⿱肉缶	又音「leu」
lu	酉酋	*	又音「cu」
luˀ	首道	*
luˀ	秀	⿱禾弓	又音「siuʰ」
luk	昱	⿱日立	少字
luk	育	⿱𠫓肉
lunˀ	允	〾人
lunˀ	尹	⿻又丨	與「聿」轉注
lut	聿	⿻又*	與「尹」轉注
luŋ	虫	*	又音「hui」
lə	㠯以台	*
lə	頤!	*	即「頤」左側結構
ləˀ	巳	*
ləiʰ	隶	⿻又毛
lək	弋	*
lək	異翼翌	*
ləm	㸒	⿱爫𡈼
ləm	覃	⿱鹵㫗
lən	寅	〾矢
ləp	習	⿱羽日	又音「sləp」
ləp	龖	⿰龍龍	少字
ləp	眔	⿱目水	又音「kʱun」「kʱui」
ləŋ	朕	⿰舟⿱丨廾	又音「lrəm」
ləŋʰ	孕	⿹乃子	獨字
lʱa	圖	⿴囗啚	獨字，或音「dʱa」
lʱa	兔	*
lʱatʰ	大太泰	*	或音「dʱatʰ」
lʱauʰ	盜	⿱㳄皿	獨字，或音「dʱauʰ」
lʱaŋ	唐	⿱庚口	「庚」聲
lʱek	狄	⿰犬火	或音「dʱek」
lʱem	甜恬	⿰舌甘	或音「dʱem」
lʱep	疊	⿱⿱日⿰日日宜	少字，或音「dʱep」
lʱeŋ	廷	⿺彳𡈼	「𡈼」聲
lʱi	弟	⿻必己	或音「dʱi」
lʱin	田	*	或音「dʱin」
lʱot	奪	⿳衣隹又	獨字，或音「dʱot」
lʱu	匋	⿴勹缶	或音「dʱu」
lʱuiʰ	㒸隊	⿱八豕	又音「sluiʰ」
lʱun	豚	⿰肉豕	與「彖」轉注
lʱunˀ	盾	*	又音「slun」「ɦlun」
lʱuk	毒	⿱屮毐	或音「dʱuk」
lʱuŋ	彤	⿰丹彡	少字，或音「dʱuŋ」
lʱəkʰ	代	⿰人弋	「弋」聲
lʱǝm	曇	⿱日⿱雨云	少字，或音「dʱǝm」
lʱəp	沓	⿱水曰	或音「dʱəp」
lʰamˀ	閃	⿵門人	少字，或音「lʰemˀ」
lʰamˀ	㚒	⿻大⿰??	少字，或音「lʰemˀ」
lʰanˀ	扇	⿸戶羽	或音「lʰenˀ」
lʰat	設	?	獨字，字源存疑，或音「lʰet」
lʰaŋ	商	⿻辛丙	一說「尚」聲音「staŋ」
lʰaŋʰ	向	⿱宀口	又音「hlaŋˀ」
lʰaˀ	鼠	*	獨字
lʰaˀ	黍	⿱禾水	獨字
lʰemˀ	閃	⿵門人	少字，或音「lʰamˀ」
lʰemʰ	㐁	*	獨字，或音「lʰəmʰ」
lʰemˀ	㚒	⿻大⿰??	少字，或音「lʰamˀ」
lʰenˀ	扇	⿸戶羽	或音「lʰanˀ」
lʰet	設	?	獨字，字源存疑，或音「lʰat」
lʰeŋ	聖聽	⿰耳呈	「呈」聲
lʰeŋˀ	甹	*	又音「pʰeŋ」
lʰi	矢	*
lʰin	身	*
lʰoʰ	戍	⿰人戈	少字
lʰoŋ	舂	⿳午廾臼	又音「tʰʱroŋ」
lʰruk	畜	⿱幺田	又音「hruk」
lʰrək	敕	⿰束攴	少字，或音「tʰrək」
lʰuˀ	手	*	獨字
lʰuʰ	嘼獸	⿱單口	獨字
lʰuiˀ	水	*	少字
lʰunʰ	舜	⿱允舛	一說「允」聲
lʰək	式	⿹弋工	「弋」聲
lʰəm	罙	⿳冖⿰丶丶又
lʰəmˀ	宷審	⿱宀釆
lʰəmʰ	㐁	*	獨字，或音「lʰemʰ」
lʰəŋ	升	〾斗	一說與「登」詞同源音「stəŋ」
lʰʱau	号	⿱口?	又音「ɦlau」、「hrau」
lʰʱau	夲	〾木	獨字，從「奏」剝離的部件，或音「lʰʱu」「tʰʱu」「tʰʱau」
lʰʱim	忝	⿱天心	「天」聲，或音「tʰʱim」
lʰʱin	天	⿱一大	或音「tʰʱin」
lʰʱu	夲	〾木	獨字，從「奏」剝離的部件，或音「lʰʱau」「tʰʱu」「tʰʱau」
lʰʱəm	貪	⿱今貝	少字，此音訓讀，本「今」音，或音「tʰʱəm」
ma	巫	*
ma	无	*	獨字
ma	無舞	*
ma	毋	〾母	獨字，「母」聲，或音「mo」
mai	麻	⿸广⿰**
man	曼	⿱冃⿳爪目又
manˀ	免	⿱冖大
manʰ	萬	*
manʰ	万	*	獨字
mat	末	*
mat	蔑	⿰⿱眉人戈	又音「mʱet」
maŋ	亡芒	*
maŋˀ	网罔	*
maˀ	武	⿱戈止
me	米	*	又音「mʱi」
me	爾尒尔	*	又音「ne」
meˀ	弭	⿰弓耳	少字
meˀ	羋	〾羊	獨字
men	丏	*
men	綿	⿰糸⿱白巾
men	面	*
men	臱	?	又音「pʱen」
met	烕	⿱戌火	「戌」聲
meu	少	〾小	「小」聲，又音「cʰeu」
meŋ	名	⿱夕口
mi	麋	⿱鹿米	「米」聲
min	民	⿻目刀
minˀ	黽	*	又音「mʱreŋ」「mʱraŋ」
mit	宓密謐	⿱宀必	「必」聲
mo	敄	⿰?攴	又音「mu」「mʱok」
mo	毋	〾母	獨字，「母」聲，或音「ma」
mrau	苗	⿱艸田	或音「mreu」
mraŋ	明	⿰日月
mraŋˀ	皿	*
mreu	苗	⿱艸田	或音「mrau」
mreŋ	鳴	⿰口鳥	獨字
mri	眉	*
mriˀ	美	⿱羊大	少字，或音「mrəiˀ」
mriu	翏	*	又音「riu」「kriu」
mruˀ	卯	*	轄「聊」音「rʱiu」
mrənˀ	敏	⿰每攴	「每」聲
mrənˀ	閔	⿵門文	「文」聲
mu	牟	⿱口牛
mu	矛	*
mu	敄	⿰?攴	又音「mo」「mʱok」
muk	目	*	獨字，或音「mək」
muk	穆	〾禾	獨字，或音「mək」
muk	牧	⿰牛攴	獨字，或音「mək」
mə	每	⿱屮母	「母」聲
mə	某	⿱甘木	少量字音「mo」「ma」
məi	微	⿲彳*攴
mrəiˀ	美	⿱羊大	少字，或音「mriˀ」
məiˀ	尾	⿸尸毛
məiʰ	未	〾木
mək	黑	*
mək	目	*	獨字，或音「muk」
mək	穆	〾禾	獨字，或音「muk」
mək	牧	⿰牛攴	獨字，或音「muk」
mən	文	〾大	-	含「閔」音mryn、「吝」音ryn
mən	昏	⿱氐日
mən	門	*
mət	勿	⿻刀⿱丶丶
məŋ	瞢夢	⿱眉人
mʱa	莫	⿴茻日	又音「mʱak」
mʱaˀ	姥	⿰女老	獨字
mʱak	莫	⿴茻日	又音「mʱa」
mʱan	㒼	⿱?㒳	少量三等
mʱau	毛	*
mʱaŋˀ	茻莽	⿱艸艸
mʱek	冪	⿱冖莫
mʱek	冥	⿱冖?	又音「mʱeŋ」
mʱek	覓	⿱𠂢見	「𠂢」聲
mʱet	蔑	⿰⿱眉人戈	又音「mat」
mʱeŋ	冥	⿱冖?	又音「mʱek」
mʱi	米	*	又音「me」
mʱoˀ	牡	⿰牛*
mʱoˀ	母	*
mʱoˀ	畞畝	*	⿰〾田又
mʱoʰ	戊	*
mʱok	木	*
mʱok	敄	⿰?攴	又音「mo」「mu」
mʱoŋ	冡蒙	⿱冃豕
mʱraˀ	馬	*
mʱrak	百	⿱一白	「白」聲，又音「pʱrak」
mʱrauk	皃	⿱囟人	又音「mʱreuk」
mʱraŋ	黽	*	又音「mʱreŋ」「minˀ」
mʱraŋˀ	孟	⿱子皿	「皿」聲
mʱreˀ	買	⿱网貝
mʱrek	𠂢	〾永	又音「pʰʱrekʰ」
mʱreuk	皃	⿱囟人	又音「mʱrauk」
mʱreŋ	黽	*	又音「mʱraŋ」「minˀ」
mʱroŋ	尨	⿻犬彡
mʱrək	麥	⿱來夊	獨字，本字即爲「來」
mʱuk	冃冒	*	少量字音「mʱok」
mʱəi	枚	⿰木?	獨字
mʱət	沒歿	⿱回又
mʰrənʰ	衅	⿰血半	後起，獨字
mʰʱaŋ	巟荒	⿱亡川	「亡」聲
mʰʱəiˀ	火	*	獨字
na	如	⿰女口	「女」聲
naˀ	女	*
nak	若	*	諧「nia」
nam	冉	*	又音「nʱəm」
namˀ	染	⿰水⿱?木	或音「nemˀ」
nan	肰然	⿰肉犬
nan	𦰩難	⿱口〾大	又音「hʱlanˀ」「nʱai」
nap	聶	⿱耳⿰耳耳	或音「nep」，又音「tap」「tep」
nau	夒擾	⿳頁⿰止巳夊
naŋ	襄	⿴衣?	又音「snaŋ」
ne	爾尒尔	*	又音「me」
nemˀ	染	⿰水⿱?木	或音「namˀ」
nep	聶	⿱耳⿰耳耳	或音「nap」，又音「tap」「tep」
neuk	弱	*
ni	尼	⿱尸人
niʰ	二	*
nimˀ	念	⿱亼心
nin	人年	*
nip	廿	⿰十十	「二」「十」合音，獨字
nit	日	*
no	需	⿱雨?	又音「sno」
noi	妥	⿱爪女	又音「nui」「snwi」
nok	辱	⿱辰又	又音「nʱuk」
non	耎	*
noŋ	茸	⿱艸耳
noŋˀ	宂冗	⿱宀人	少字
noˀ	乳	⿰⿱爪子乃	少字
nonˀ	㞋軟	*
nrap	㚔	*	獨字，或音「nrep」
nrauʰ	鬧	⿵鬥市	或音「nreuʰ」「nruʰ」
nrep	耴	*	又音「tʱep」「trep」
nrep	㚔	*	獨字，或音「nrap」
nreuʰ	鬧	⿵鬥市	或音「nrauʰ」「nruʰ」
nroŋ	農	⿱⿴艸田辰	又音「nʱuŋ」
nruʰ	鬧	⿵鬥市	或音「nrauʰ」「nreuʰ」
nrək	匿	⿷匚若	「若」聲
nu	柔	*
nui	妥	⿱爪女	又音「noi」「snwi」
nuk	肉	*	獨字
nun	閏	⿵門王	少字
nut	內	⿱宀冂	又音「nəp」
nuŋ	戎	⿻戈甲
nuˀ	丑	〾又
nə	而	*
nə	耳	*
nəm	壬任	*
nənˀ	刃	⿰丶刀
nəp	入	*	獨字
nəp	內	⿱宀冂	又音「nut」
nəŋ	乃	*	又音「nʱəˀ」
nʱa	奴	⿰女又	「女」聲
nʱai	那	⿰冉邑	「冉」聲
nʱai	𦰩難	⿱口〾大	又音「hʱlanˀ」「nan」
nʱat	柰奈	⿱木示
nʱauˀ	匘!	⿱巛囟	或音「nʱuˀ」
nʱeuʰ	尿	⿸尸水	獨字
nʱeŋ	寍寧	⿱心皿
nʱuˀ	匘!	⿱巛囟	或音「nʱauˀ」
nʱuk	辱	⿱辰又	又音「nok」
nʱunʰ	嫩	⿰女軟	「軟」聲
nʱuŋ	農	⿱⿴艸田辰	又音「nroŋ」
nʱə	能	*	又音「nʱəŋ」
nʱəˀ	乃	*	又音「nəŋ」
nʱəm	南	*
nʱəm	冉	*	又音「nam」
nʱəm	男	⿱田力	獨字
nʱəŋ	能	*	又音「nʱə」
pa	夫	⿻大一
pa	甫	⿱屮田	或說形「⿱父用」
pa	尃	⿱⿱屮田又	「⿱屮田」聲，又音「pak」
paˀ	父	*	含「布」
pai	皮	*
pak	尃	⿱⿱屮田又	「⿱屮田」聲，又音「pa」
pam	卩㔾	*	此「氾犯範」聲旁，又音「pəi」
pam	乏	〾正	又音「bap」
pan	釆番	*
panˀ	反	⿸厂又
pap	法灋	⿰水?	獨字
pat	癶癹發	⿰↔止止
pat	犮	〾犬	又音「pət」
pat	巿	*
pau	票	?	或音「peu」
paŋ	方	〾刀
pe	卑	⿱甲又
pek	辟	⿰卩辛
pen	便	⿰人⿱免攴
pen	扁	⿸戶冊
penˀ	辡	⿰辛辛
pet	㡀敝	〾巾
peu	票	?	或音「pau」
peu	髟	⿰镸彡	獨字，又音「piu」
peu	猋	⿱犬⿰犬犬
peŋ	并	⿻从一
pi	比	⿰匕匕
piˀ	匕	*
piʰ	畀鼻	*
pin	賓	⿳宀丏貝
pit	必	⿴八戈	「八」聲
pit	畢	*
pit	閉	⿵門*	獨字
piu	彪	⿰虎彡	獨字
piu	髟	⿰镸彡	獨字，又音「peu」
po	付	⿰人又
pok	卜	*
poŋ	丰奉豐	*
poŋ	封	⿰⿱丰土又	「丰」聲，又音「pʱaŋ」
pra	膚	⿱盧肉	獨字，「盧」聲
prai	罷	⿱网能	或音「pre」
pranʰ	弁卞	⿱?廾	又音「prənʰ」
prau	麃	⿱鹿火
prauˀ	表	⿴衣毛	少字，或音「preuˀ」
praŋ	兵	⿱斤廾	少字
praŋˀ	丙	*
praŋˀ	秉	⿻禾又	獨字
pre	罷	⿱网能	或音「prai」
pret	八	*
pret	別	⿰冎刀
preuˀ	表	⿴衣毛	少字，或音「prauˀ」
prəˀ	啚鄙	⿱囗㐭
prəmˀ	品	⿱口⿰口口	獨字
prənʰ	弁卞	⿱?廾	又音「pranʰ」
prəŋ	仌冰馮	*
puˀ	缶	⿱午口
puk	复	⿱*夊
puŋ	風鳳	⿵凡虫	「凡」聲，早期音「pəm」
pə	不否	*
pəi	非	*
pəi	卩己巴	*	此「妃配肥」聲旁，又音「pam」
pəi	飛	*	獨字
pək	畐	*
pəm	風鳳	⿵凡虫	「凡」聲，晚期音「puŋ」
pən	賁奔	⿱卉貝
pənˀ	奮	⿳衣隹田	少字
pən	分	⿱八刀
pənʰ	糞	⿳小其廾	少字
pət	弗	⿻⿰丨丨己
pət	犮	〾犬	又音「pat」
pəŋ	朋	*
pʱaʰ	布	⿱父巾	「父」聲
pʱai	波	⿰水皮	「皮」聲
pʱanˀ	半	⿱八牛	少量平聲
pʱan	般	⿰凡攴
pʱatʰ	貝	*
pʱauk	暴	⿳日廾米
pʱaŋ	旁	⿱凡方	「方」聲
pʱaŋ	封	⿰⿱丰土又	「丰」聲，又音「poŋ」
pʱen	臱	?	又音「men」
pʱi	毘	⿱囟比	「比」聲
pʱi	坒	⿱比土	「比」聲
pʱok	菐	*
pʱra	巴	*
pʱrak	白百	*	「百」又音「mʱrak」
pʱrak	䩗霸	⿰革月	少字
pʱran	班斑	⿲玉刀玉
pʱreuk	勺	*	又音「teuk」
pʱroŋ	邦	⿰丰邑	「丰」聲
pʱru	勹包	*	又音「pʱruk」
pʱruk	勹包	*	又音「pʱru」
pʱrəiʰ	拜	⿰手?	少字
pʱu	保	⿰人⿻子八
pʱuʰ	報	⿲㚔卩又	獨字
pʱək	北	⿰人𠤎
pʱənˀ	本	*	少字
pʱət	孛	⿱?子
pʰa	敷	⿰旉攴	「尃」聲
pʰeŋ	甹	*	又音「lʰeŋˀ」
pʰit	匹	⿸石乙	少字
pʰo	孚	⿱爪子	又音「bu」
pʰrə	丕	⿱不一	「不」聲
pʰətʰ	費	⿱弗貝	「弗」聲
pʰʱenʰ	片	*	少字，或音「pʰʱinʰ」
pʰʱinʰ	片	*	少字，或音「pʰʱenʰ」
pʰʱrau	拋	*	或音「pʰʱru」「pʰʱreu」
pʰʱrekʰ	𠂢	〾永	又音「mʱrek」
pʰʱreu	拋	*	或音「pʰʱru」「pʰʱrau」
pʰʱreŋ	平	*	又音「breŋ」
pʰʱru	拋	*	或音「pʰʱrau」「pʰʱreu」
ra	閭	⿵門吕	「吕」聲
ra	盧	⿳虍*皿	「虍」聲
raˀ	吕呂	*
raˀ	旅	⿸㫃从
raʰ	慮	⿱盧心	「盧」聲
rai	离	*
rak	略	⿰田各	「各」聲
ramˀ	僉	⿳亼⿰口口⿰人人	又音「kramˀ」「hramˀ」「ŋramˀ」
rap	巤	⿱?鼠
rat	厲	⿸厂萬	「萬」聲
rat	列	⿰歺刀
rau	尞	〾⿻木火	又音「reu」
raŋ	京	⿳亠口?	又音「kraŋ」
raŋ	良	*
raŋ	量	⿱?東
raŋ	刅梁	⿰刃丶	少字
raŋˀ	㒳兩	*
re	麗丽	⿱*鹿
rem	兼	⿻又⿰禾禾	又音「kʱlem」
ren	連	⿰辵車
reu	尞	〾⿻木火	又音「rau」
reŋ	令	⿱亼卩
riʰ	利	⿰禾刀
rin	粦	*
rit	栗	⿱*木
riu	翏	*	又音「kriu」「mriu」
ro	婁	⿱⿴⺽角女
roi	羸!	*	即「羸」除羊以外結構，又音「leŋ」
roiˀ	厽	⿱土⿰土土	少字
roi	累	⿱畾糸	「畾」聲，又音「rui」
rok	彔	*
ron	䜌	⿲糸言糸
ron	聯!	⿱⿰幺幺丱	即「聯」右側結構，少字
rot	劣	⿱少力	獨字
rot	寽	⿳爪丶又
roŋ	龍	*
ru	㐬	⿱𠫓川
ru	留	⿱卯田	「卯」聲
ru	劉	⿰⿱卯今刀	「卯」聲
rui	累	⿱畾糸	「畾」聲，又音「roi」
ruiˀ	耒	*	少字
ruk	六坴	*
run	侖	⿱亼冊
rut	律	⿰彳聿	「聿」聲
rut	率	⿻〾幺⿰⿱丶丶⿱丶丶	又音「srut」
rutʰ	頪	⿰米頁
ruŋ	夅隆	⿱夊㐄	又音「kʱruŋ」
rə	里	⿱田土
rə	𠩺	⿰⿱木?攴
rəˀ	李	⿱木子
rək	力	*
rəm	林	⿰木木
rəmˀ	㐭稟禀	*
rənʰ	吝	⿱文口	「文」聲
rənʰ	閵	⿵門隹
rəp	立	⿱大一
rəŋ	夌	⿳木人夊
rʱaˀ	虜	⿱盧力	「盧」聲
rʱaˀ	鹵	*
rʱai	羅	⿱网⿰糸隹
rʱak	各	⿱夊凵	又音「kʱlak」
rʱakʰ	路	⿰足各	「各」聲
rʱam	監	⿱⿰臣人皿	又音「kʱramˀ」
rʱan	闌	⿵門柬
rʱat	剌	⿰束刀
rʱatʰ	賴	⿰剌貝	「剌」聲
rʱau	勞	⿱⿰火火⿴衣⿲丶丶丶
rʱauk	樂	⿱⿲幺白幺木	又音「lauk」「leuk」「rʱeuk」
rʱeiʰ	隸!	⿰⿱木示又	或音「rʱəiʰ」
rʱek	秝厤歷	⿰禾禾
rʱek	鬲	*	又音「kʱrek」
rʱenʰ	柬	*	又音「kʱrenˀ」
rʱepʰ	劦	⿱力⿰力力	又音「ɦep」
rʱeu	料	⿰米斗	獨字
rʱeuˀ	了	*	少字
rʱeuk	樂	⿱⿲幺白幺木	又音「rʱauk」「lauk」「leuk」
rʱeŋ	霝	⿱雨⿲口口口
rʱeŋ	灵	*	後起，獨字
rʱiˀ	豊	⿱⿰玉玉壴
rʱiˀ	礼	⿰示乙	獨字
rʱit	戾	⿸戶犬	或音「rʱət」，又音「rʱut」
rʱoʰ	屚	⿸屋雨	少字
rʱoʰ	㔷陋	⿷匚丙	獨字
rʱok	鹿	*
rʱonˀ	卵	*	獨字
rʱonʰ	亂	⿰⿳爪幺又乚	獨字
rʱoŋʰ	弄	⿱玉廾
rʱu	牢	⿻宀牛
rʱuˀ	老耂	*	與「考」轉注
rʱui	畾	⿱⿰***
rʱui	雷	⿱雨〾申	「畾」聲
rʱuiˀ	磊	⿱石⿰石石	獨字
rʱut	戾	⿸戶犬	又音「rʱit」「rʱət」
rʱə	來	*
rʱəiʰ	隸!	⿰⿱木示又	或音「rʱeiʰ」
rʱət	戾	⿸戶犬	或音「rʱit」，又音「rʱut」
sa	胥	⿱疋肉	「疋」聲
sai	徙	⿰辵沙	「沙」聲
sak	昔	⿱〾川日	又音「cak」
san	䙴	?	或音「sen」，又音「cʰan」或「cʰen」
san	仙	⿰人山	獨字，或音「sen」
san	鮮	⿰魚羊
sanˀ	㪔散	⿰林攴	轄「霰」音「senʰ」
sauʰ	笑	⿱竹犬
saŋ	相	⿰木目
se	斯	⿰其斤
sen	䙴	?	或音「san」，又音「cʰan」或「cʰen」
sen	仙	⿰人山	獨字，或音「san」
seu	小肖	*
seŋˀ	省	⿱生目	「生」聲
si	厶私	*	少字
siˀ	死	⿰歺𠤎	獨字
siʰ	㣇肆	*	又音「liʰ」
siʰ	四亖	*
sia	些	⿱此二	「此」聲，獨字
siaˀ	舄	*	又音「siak」
siak	舄	*	又音「siaˀ」
sinʰ	卂	〾飛
sin	辛新	*
sinʰ	信	⿰人言	獨字
sip	卌	⿰⿰十十⿰十十	「四」「十」合音，獨字
sit	悉	⿱釆心
siu	肅	⿱聿淵	又音「siuk」
siu	攸	⿰人攴	又音「liu」「liuk」
siuʰ	秀	⿱禾弓	又音「luˀ」
siuk	肅	⿱聿淵	又音「siu」
slak	夕	〾月	少字
slak	席	⿸石巾	少字，「石」聲
slanʰ	㳄羨	⿰水欠	或音「slenʰ」
slaŋˀ	象	*
slenʰ	㳄羨	⿰水欠	或音「slanʰ」
sloi	隋	⿰阜⿱⿸又土肉	「⿰阜⿸又土」聲，又音「loi」「soi」
sloŋ	松	⿰木公	「公」聲
slu	囚	⿴囗人	少字
sluiʰ	㒸遂	⿱八豕	又音「lʱuiʰ」
slun	盾	*	又音「lʱunˀ」「ɦlun」
slə	司	⿱?口	又音「sə」
slə	辭	⿰⿳爪幺又辛	獨字
sləm	尋	⿰㐁⿱又又
sləp	習	⿱羽日	又音「ləp」
sləp	襲	⿱龍衣	少字，「龖」音
smit	戌	*
snaŋ	襄	⿴衣?	又音「naŋ」
sno	需	⿱雨?	又音「no」
snui	妥	⿱爪女	又音「nui」「noi」
so	須	⿰彡頁
soi	隋	⿰阜⿱⿸又土肉	「⿰阜⿸又土」聲，又音「loi」「sloi」
sok	束欶	*
sok	粟	⿱?米	少字
sonˀ	算	⿱竹具	又音「cʰonˀ」
sonˀ	巽!	⿰卩卩	即「巽」上方結構，又音「zonˀ」
sot	雪	⿱雨?	獨字
sra	疋疏疎	*
sraˀ	所	⿰?斤	少字
sram	彡	〾三	「三」聲
sran	山	*
srat	殺煞	⿰⿱?卩殳
sraŋ	霜	⿱雨相	「相」聲
sraŋˀ	爽	⿻大⿰口口	又音「cʰraŋˀ」
sreŋ	生	⿱屮土
sri	師	⿰𠂤帀
sroˀ	數	⿰婁攴	「婁」聲
srot	㕞刷	⿰⿱尸巾又	少字
sru	叟	⿳宀火又	又音「sʱu」
srui	衰!	*	即「衰」中間結構
srut	率	⿻〾幺⿰⿱丶丶⿱丶丶	又音「rut」
srut	帥!	⿰丨⿱↕又↕又	即「帥」左側結構
srəˀ	史吏	⿱中又
srək	嗇	⿱來㐭	「來」聲
srək	色	⿰爪卩	獨字
srəm	參	⿱晶彡	又音「cʰʱəm」「sʱəm」「cʰrəm」
srəm	森	⿱木⿰木木	獨字
srən	先	⿱之人	又音「sʱən」
srəp	歰	⿰⿱↺止止⿱↺止止
sta	書	⿱聿者	獨字，「者」聲
stit	室	⿱宀至	少字，「至」聲
suk	夙	⿰月丮	少字
suk	宿!	⿰人㐁	即「宿」下放結構
sut	卒	⿻衣一	又音「cut」
sut	祟	⿱木示
suŋ	嵩	⿱山高	獨字
sə	司	⿱?口	又音「slə」
sə	思	⿱囟心	「囟」聲
sə	絲	⿰糸糸
sək	息	⿱自八
səm	心	*	少字
sən	囟	*
sʱai	沙	⿰水少
sʱak	索	⿻糸廾	與「素」一字分化
sʱakʰ	素	⿻糸廾	與「索」一字分化
sʱam	三	*
sʱanˀ	傘	*	獨字
sʱap	卅	⿲十十十	「三」「十」合音，獨字
sʱaŋ	桑	*
sʱeʰ	細	⿰糸囟	少字，「囟」聲
sʱek	析	⿰木斤
sʱet	屑	⿸尸⿱八肉	或音「sʱǝt」「sʱit」
sʱeŋ	星	⿱日生	「生」聲
sʱi	犀	⿸尾牛	獨字
sʱit	屑	⿸尸⿱八肉	或音「sʱet」「sʱǝt」
sʱoiˀ	瑣!	⿱小貝	即「瑣」右側結構，少字
sʱoiˀ	惢	⿱心⿰心心	獨字，又音「zoiˀ」
sʱonʰ	祘蒜	⿰示示	少字
sʱonʰ	筭	⿱竹弄	獨字
sʱoŋʰ	送	⿰辵?
sʱran	刪	⿰冊刀
sʱroŋ	雙	⿱⿰隹隹又
sʱu	蚤	⿱㕚虫	「㕚」聲，又音「cʱuˀ」
sʱu	叟	⿳宀火又	又音「sru」
sʱuˀ	掃	⿰手帚	後起，獨字
sʱun	孫	⿰子糸
sʱuŋʰ	宋	⿱宀木	獨字
sʱəi	西	*
sʱək	塞!	⿳宀㠭廾	即「塞」上方結構
sʱəm	參	⿱晶彡	又音「cʰʱəm」「cʰrəm」「srəm」
sʱən	先	⿱之人	又音「srən」
sʱǝt	屑	⿸尸⿱八肉	或音「sʱet」「sʱit」
sʱǝŋ	曾	⿱*曰	又音「cǝŋ」
sŋʱak	斥	⿸广屰	「屰」聲
ta	者諸	*	諧「tia」
tak	石庶	⿸厂口
tam	詹	⿸厃⿱八言
tan	單	*
tan	亶	⿱㐭旦	「旦」聲
tan	旃	⿸㫃丹	少字，「丹」聲
tanˀ	善	⿱羊⿰言言
tap	聶	⿱耳⿰耳耳	或音「tep」，又音「nap」「nep」
tat	折	⿰〾木斤	又音「tet」
tatʰ	帶	*	又音「tetʰ」
tatʰ	制	⿰朱刀	或音「tetʰ」
teu	召	⿱刀口	「刀」聲
taŋ	章	*
taŋˀ	敞	⿰尚攴	「尚」聲
te	是	⿱日正
te	氏	*	又音「ge」
tek	啇	⿱帝口	「帝」聲
tek	隻	⿱隹又	獨字
tem	占	⿱卜口
tep	聶	⿱耳⿰耳耳	或音「tap」，又音「nap」「nep」
tet	折	⿰〾木斤	又音「tat」
tetʰ	帶	*	又音「tatʰ」
tetʰ	制	⿰朱刀	或音「tatʰ」
teuk	勺	*	又音「pʱreuk」
teuk	弔	⿻人己	少字
teŋ	正	⿱丁止	「丁」聲
ti	氐	⿱氏丶
tiak	炙	⿱肉火	少字
tin	真	⿱*鼎
tip	執	⿰㚔丮
tit	斦質	*	或音「tǝt」
tit	至	↺矢
to	朱	*
toˀ	主	*
toi	垂	⿱*土
tok	屬	⿸尾蜀	「蜀」聲
trok	豖	⿻豕丶
ton	耑	⿱屮不	少量字音「tʱoiˀ」
ton	專	⿱叀又
tot	叕	*	又音「trot」
toŋ	重	⿳人東土
toŋ	童	⿳辛東土
tra	豬猪	⿰豕者	「者」聲
traˀ	宁	*
trak	著箸	⿱艸者	「者」聲
tranˀ	㠭展	⿱⿰工工⿰工工
trau	朝	⿰⿳屮日屮月	少字
traŋ	長	*
tre	知	⿰矢口
trep	耴	*	又音「tʱep」「nrep」
treŋ	貞	⿱卜鼎	「鼎」聲
tritʰ	疐	⿱?止
tritʰ	致	⿰至攴	「至」聲
trot	叕	*	又音「tot」
troŋˀ	冢	⿱冖豖	「豖」聲
truʰ	晝	⿱聿日	獨字
truŋ	中	*
trǝk	陟	⿰阜步	少字
trǝŋ	徵!	?	即「徵」右側結構
tu	周	5468	⿱用口	-
tu	壽	58FD	⿳老?口	⿲口乙口	簡化爲古形，乙象流水，爲「疇」本字
tu	州	5DDE	〾川	-
tu	舟	821F	*	-	含「受」
tui	垖!	5796	*	-	從原形，含「追」
tuih	對	5C0D	⿰⿱丵土又	⿰丵又
tuk	叔	53D4	 ⿰⿱弋土又	-
tuk	祝	795D	⿰示⿱口人	-
tuk	竹	7AF9	*	-
tuk/luk	粥	7CA5	〾米	-
tun	屯	5C6F	*	-
tun	敦	6566	⿰⿱亯羊攴	⿰⿱亠口攴	作「亯」，從「⿱亯羊」省
tuŋ	冬	51AC	⿱*仌	*	簡化從「終」古字，象繩兩端
tuŋ	眾	773E	⿱日⿱人⿰人人	⿱人⿰人人
tuʔ	帚	5E1A	*	-
tuʔ	肘!	5BF8	九	-
ty	㞢	37A2	〾止	-	兩個來源，甲骨此形象牛頭，假以記「有又」字，後世和「之」異體同形
ty	之	4E4B	〾止	-
tyk	㝵	3775	⿱貝又	⿰貝又	從古略微變形
tyk	戠	6220	⿰音戈	-	「音」或從「弋」
tyk	直	76F4	*	-	從古略微變形
təm	冘沉	⿻人?
tym/khym	甚	751A	*	-
tymʔ	丼	4E3C	⿴井丶	-	後起
tyn	㐱	3431	⿱人彡	-
tyn	辰	8FB0	*	-
tyn/tun	殿!	6BBF	⿸尸几	-
tynʔ	典	5178	⿱冊廾	-
tǝt	斦質	*	或音「tit」
tyŋ	氶	6C36	⿱廾卩	-	從古形
tyŋ	登	767B	⿱癶豆	-
tyʔ	止	6B62	*	-
tʱaˀ	土	*
tʱan	丹	*	少字
tʱanˀ	旦	⿱日一	又音「tʱat」
tʱap	耷	⿱大耳	少字
tʱau	刀到	*
tʱaŋ	當	⿱尚田	「尚」聲
tʱaŋˀ	黨	⿱尚黑	「尚」聲
tʱekʰ	帝	*
tʱep	耴	*	又音「trep」「nrep」
tʱeŋ	丁	*
tʱeŋˀ	鼎	*
tʱiuˀ	鳥	*
tʱo	豆	*
tʱo	兜	⿴?皃
tʱoˀ	斗	*
tʱoʰ	鬥	*	獨字
tʱoiˀ	朵	*
tʱonˀ	斷	⿰㡭斤	少字
tʱonʰ	段	⿰石殳
tʱoŋ	東	*
tʱrak	乇	*
tʱrauk	卓	*
tʱəp	荅答	⿱艸合	「合」聲
tʰak	斥	⿸广乇	「乇」聲
thak	尺	5C3A	*	-	一說「乇」聲
thaŋ	昌	660C	⿱日曰	-
theŋ	爯	722F	⿱爪再	-
thih	替	66FF	⿱⿰立立日	⿰夫夫
tʰret	徹!	*	即「徹」右側結構，又音「dret」，或音「lret」
thoi	吹	5439	⿰口欠	-
thok	禿	79BF	⿱禾儿	-
thon	穿	7A7F	⿱穴牙	-
thonʔ	舛	821B	⿰夊㐄	-
thrimh	闖	95D6	⿵門馬	-
tʰrək	敕	⿰束攴	少字，或音「lʰrək」
tʰu	雔	96D4	⿰隹隹	少字，或音「du」
thuiʔ	退	9000	⿰辵⿱皀夊	⿱皀夊
thut	突	7A81	⿱穴犬	-
thuŋ	充	5145	⿱𠫓人	-
tʰu	雔	⿰隹隹	少字，或音「du」
tʰʱak	橐	⿴束石	少字，「石」聲
tʰʱau	夲	〾木	獨字，從「奏」剝離的部件，或音「tʰʱu」「lʰʱu」「lʰʱau」
tʰʱim	忝	⿱天心	「天」聲，或音「lʰʱim」
tʰʱin	天	⿱一大	或音「lʰʱin」
tʰʱroŋ	舂	⿳午廾臼	又音「lʰoŋ」
tʰʱu	夲	〾木	獨字，從「奏」剝離的部件，或音「tʰʱau」「lʰʱu」「lʰʱau」
tʰʱəm	貪	⿱今貝	少字，此音訓讀，本「今」音，或音「lʰʱəm」
wa	壺	58FA	*	-
wa/ʔwa/kwa	于	4E8E	*	-	含「亏」
wai	爲	7232	⿱爪象	*隸變調整⿳{矢字頭}{貝字底}
wai	禾	79BE	*	-	含「科委」
wai/ŋwai	𠤎	2090E	⿿人	-
wak	蒦	84A6	⿱隹又	-	從古形
wan	〇	3007	〇	-	象圓形，含「員袁睘」
wan	丸	4E38	*	-
wan	亘	4E98	〾回	-
wan	奐	5950	⿳人穴廾	-	從古略微變形
wan	爰	7230	⿳爪丨又	-	從古略微變形
wan	萈	8408	⿱羊兔	-	從古形
wat	戉	6209	*	-
wat	曰	66F0	*	-
waŋ	王	738B	*	-
waŋ	皇!	7687	*	-	從古形
waŋ	黃	9EC3	*	-
waʔ	戶	6236	½門	-
waʔ	禹	79B9	*	-
waʔ	羽	7FBD	*	-
waʔ	雨	96E8	*	-
we	巂	5DC2	⿱〾隹丙	⿱屮隹
weih	軎	8ECE	⿱車〇	-
wek	役	5F79	⿰人殳	-	從古形
wen	旋	65CB	⿸㫃足	⿸㫃止
wen	縣	7E23	⿰首糸	-	略微變形
wen	肙	8099	*	-
wet	彗	5F57	*	-
weŋ	頃	⿰匕頁	諧「kueŋ」
weŋ	熒!	7192	⿱⿰火火冖	⿰火火
whryŋ/whreŋ	轟	8F5F	⿱車⿰車車	-
wi	回	56DE	*	-
win	旬!	65EC	*	-	從古形，無「日」，象形，一說象「螾」，含「匀」，含「軍」音kun，含「訇」音wreŋ
win	玄	7384	〾幺	-
wit	矞	77DE	⿱矛?	-
wit	穴	7A74	*	-
wra	華	83EF	⿱艸〾垂	-	從古略微變形
wranh	宦	5BA6	⿱宀臣	-
wrap	曄	66C4	⿰日華	-
wraŋʔ	永	6C38	⿻川人	-
wrek	畫	756B	⿱聿田	-	從古略微變形
wrinh	幻	5E7B	〾幺	-
wryŋ	厷	53B7	⿹又?	-
wui	韋	97CB	⿳↔止囗↕止	囗
wui/tui/cui/syuin	隹	96B9	*	-	含「唯椎淮崔隼」
wy	又	53C8	*	-
wy	郵	90F5	⿰垂邑	-
wyk	或	6216	⿰囗戈	-
wym	熊	718A	⿱能?	-
wyn	云	4E91	*	-
wyt	胃!	80C3	*	-
wǝ	尤	5C24	⿻又丶	-
wʱat	咶!	⿱?口	即「咶」右半結構，或音「kʱot」
wʱat	會	⿴合?	或音「kʱot」
wʱaŋ	晃	⿱日光	「光」聲
wʱe	圭	*	又音「kue」「hue」「ʔue」
wʱitʰ	惠	⿱叀心
zauk	凿	51FF	⿱丵臼	-
zaŋ	牆	723F	⿰爿嗇	-	「爿」聲
zaŋh	匠	5320	⿷匚斤	-
zih	自	81EA	*	-
zinʔ	盡	76E1	⿳聿水皿	-
zit	疾	75A2	⿸疒矢	-
zo	聚	805A	⿱取⿲人人人	-	「取」聲
zoiˀ	惢	⿱心⿰心心	獨字，又音「sʱoiˀ」
zon	全	⿱入玉	又音「cʰon」，或音「zuan」「zuen」
zon	泉	6CC9	⿱*水	-	又音「cʰon」，或音「zuan」「zuen」
zonˀ	巽!	⿰卩卩	即「巽」上方結構，又音「sonˀ」
zra	助	52A9	⿰且力	「且」聲
zram	毚	6BDA	⿱兔兔	-	又音「cʰram」
zruŋ	崇	5D07	⿱山宗	「宗」聲
zryʔ	士	58EB	*	-
zuiʔ	罪	7F6A	⿱网非	-
zuʔ	造	9020	⿰辵⿱屮口	-	從古略微變形
zǝh	字	5B57	⿱宀子	「子」聲
#zǝk	賊	8CCA	⿰則戈	非三等，「則」聲
zyn	存	5B58	⿱才子	-	「才」聲
zʱǝʔ	在	⿸才土	「才」聲
ŋa	五	4E94	*	-	含「吾」
ŋa	午	5348	*	-	含「卸御」
ŋa	魚	9B5A	*	-	含「穌」音sa，「魯」raʔ
ŋah	馭	99AD	⿰馬又	-
ŋai	宜	5B9C	⿻且多	-	「宜宐」即半「⿻且多」形
ŋai	我	6211	*	-
ŋak	噩	5669	⿳吅桑吅	⿱吅木	含「咢」
ŋam	嚴	6562	⿱吅⿸厂敢	「敢」聲
ŋan/ŋat	鬳	9B33	⿸虍鬲	-
ŋan/ŋhan	厂	5382	*	-	即「岸」，含「彥產炭」
ŋan/ŋyn	言	8A00	*	-
ŋap	業	696D	⿱丵大	-
ŋat	乂	4E42	*	*	即2C516，含「辥豙乂薩」
ŋat	歺	6B7A	*	-
ŋau	囂	56C2	⿳吅頁吅	⿱吅頁
ŋau	敖!	6556	*	-	古從「敖」左側
ŋauk	虐	8650	⿰虍人	-	從古形
ŋaŋ	卬	536C	⿰𠤎卩	-
ŋe	兒	5152	⿱?人	-	人上臼形象小兒頭顱未合
ŋen	艮	*	又音「kʱen」
ŋet	埶	57F6	⿰⿱木土丮	⿰木丮
ŋet	臬!	81EC	⿰自刀	-
ŋeu	堯	582F	⿱⿱土⿰土土兀	⿱土兀	甲骨文形⿱土兀
ŋo	禺	9B3C	*	-
ŋoi	厃	5383	⿱人石	-	含「危」
ŋoih	臥	81E5	⿰臣人	-
ŋok	獄	7344	⿲犬言犬	⿰犬犬
ŋok	玉	7389	*	-
ŋon	元	5143	〾人	-
ŋon	原	539F	⿸厂泉	-
ŋot	月	6708	*	-
ŋrak	屰	5C70	*	-
ŋram	岩	5CA9	⿱山石	後起
ŋramʔ	僉	⿳亼⿰口口⿰人人	又音「kramʔ」「hramʔ」「ramʔ」
ŋre	厓	⿸厂圭	「圭」聲
ŋroiʔ	瓦	74E6	*	-
ŋrok	岳	5CB3	⿱丘山	-
ŋrym	嵒	5D52	⿱品山	-
ŋui	嵬魏	⿱山鬼	「鬼」聲
ŋut	兀	5140	〾人	-	來源不明，或從「元」
ŋwa	吳	5433	⿰夨口	-
ŋwy	牛	725B	*	-
ŋy	疑!	7591	⿱?大	-	從古形
ŋǝi	豈	⿱?豆	又音「kǝi」
ŋəm	今	⿱亼一	又音「kəm」「hʱəm」
ŋǝn	斤	*	又音「kən」「hən」
ŋyp/lhyp/henʔ	㬎	3B0E	⿱日絲	⿱日幺	顯音不同源而形同
ŋǝt	乞	〾气	「kǝt」「hǝt」
ŋʱen	幵	⿰干干	又音「kʱen」
ŋʱra	牙	*
ŋʱrǝm	咸	⿹戌口	「kʱǝm」「hʱǝm」「klǝm」
-	㐄冖冂㫃丨丿乀乚亼凵匚匸卩吅夊宀屮巜广彑彳疒禸糸豕辵𠫓壴叀