# 字	聲	本字
與	与	舁
谻	[谷]	丮
虖	虍	乎
罔	亡	网
冪	幕	冖
嘏	古	叚
嚮	鄉	向
尪	王	尢
龏	龍	廾
雚	吅	雈
草	早	艸
糴	翟	籴
糶	翟	粜
鬪	尌	鬥
鬭	斲	鬥
釐	里	𠩺
魏	委	嵬
㪷	豆	斗
哿	加	可
# 字	雙同聲
舒	舍予
牄	爿倉
卙	甚十
𢫅	托七	# 越南
在	才士
虧	雐亏
斄	𠩺來
斳	堇斤
耻	耳止
# 字	雙異聲
㝬	害夫
㢂	广𠂤
㗮	名庚	# 越南
# 異字同形
姥	姥	古
姥	老	今
氂	毛	氂牛
氂	𠩺	毫氂