# 本表聲旁及轄字無重覆
# 少量轄字的聲化字的附屬字()標示
# 特殊情況用[]標示
𦥑	⺽䳔閰𦥑
〇	〇
㐁	㐁䄼䇧
㐄	㐄
㐬	㐬㲙䖻旒橀流(瑬蓅鎏𠺩)琉硫裗酼(醯)鋶锍麍
㐭	㐭顲
禀	凛廪(䕲)懔檩燷癝禀𪷤
稟	凜壈廩(𤃢𤒢𦢵)懍檁澟燣癛稟𡗋𢀮𢶸𣱭𤢤𤯑𥋶𦡣𨮍𩆐𩇆𩼤
㐱	㐱䂦䑐䝩䪾抮昣殄(餮)沴珍(𠗰𣹗)畛疹眕紾聄胗袗診诊趁(𦼛𦼜)跈軫(𤺋)轸鉁飻駗𠃩𠱉𤇪𤒙
㒸	㒸㥞㴚䃍䠔䯟煫𦂁
隊	䉌䔹䥙墜鐆隊𠾕𡑖𡡦𢢊𢵌𣾶𤏢𥖐𦅭𦠵𧥃𨅷
队	坠队
㒼	㒼㙢㨺䊟䐽䝡䤍慲暪樠璊瞞(𤃞)蟎襔蹣鏋顢鬗𡠪𤡁
𬜯	瞒螨蹒颟𫞩𬜯
滿	懣滿𡒗𤅎𤾯𩯮
满	懑满
満	満𢡛
㓞	㓞㛃㸷㼤䂮恝(瘛)挈(㮮䤿𢹫)栔洯蛪觢齧(䥹囓)𢹫𪘂
契	㓶㝣䚉䝟䦬䫔䱮偰喫契揳楔猰瘈碶禊稧窫葜褉鍥锲𢝛𤋸𩴅
絜	䐼䥛噄潔絜緳𡐤𤏦
㔷	㔷陋
[己]	圮妃
配	嶏蓜配
肥	䈈俷淝肥萉蜰𤷂
㕞	㕞
刷	刷唰涮𤷯
㕡	㕡壑
㕢	㕢䪥
韰	㒠瀣薤韰
㕣	㔯㕣㫟䛇兗(渷)沿船鉛铅
[公]	㳂兖(萒)舩鈆
袞	䙛滾(𡁺)蔉袞𠽓𥐐𥕦𦄣𨎊
衮	㙥㨰䜇滚磙蓘衮𨍽
㚅	㚅湰
隆	㝫㦕䃧嶐漋癃窿隆霳鿧𠾐
㚇	㚇㣭㨑䁓䈦䍟䎫堫嵏嵕惾朡椶猣稯糉緵翪艐葼蝬鍐騣鬉鬷鯼𥊙𩋯
[⿳⿶凵⿳丶⿲丶乂丶丶儿夊]	㯶糭鑁
㚒	㚒㣣㪎陝鿃
[夹]	陕
㚔	㚔
㝵	㕌㝵㝶㥂㧹䅞䎪䙷䙸䚟得(嘚𡐙𥊤)棏淂碍(𠿴𢣀𦡡)鍀锝𠊚𠊛𠵨𣈗𣈜𤊢𥇹𥋹𧍋𪖭
軟	㜛簐軟𣼴𥊡𨅄
嫩	嫩𡁛𡽫(𡄨)𥶄𧀒
软	软
㞷	㞷匩
往	往徃徍暀𠗤𤷮
㠭	㠭
㠯	㚶㠯㭒佀耜苢鈻
以	㕽䎣䬮以似(娰)姒拟泤笖苡鉯
㡀	㡀㢼䘷䭱䳤
㡭	㡭檵継繼
继	继
[斥]	泝訴(𤏣)诉
肆	肂肄肆蕼
㤅	㤅
㥯	㒚㡥㥯䌥䭡嶾懚檼濦穩(𡅯)
[急]	稳
[⿳爫𫜹心]	穏
隱	㦩㶏䨸櫽癮蘟讔隱
隐	瘾隐𦻕
隠	隠
㦰	㦰
[⿱目又]	㩊
㫃	㫃
㬎	㙷㬎㬤䏉䜙儑濕礘隰
[㬎]	䗾䥪韅顯(灦𡆘)
溼	溼
显	㫫显顕
湿	湿
㱿	㜌㝅㨌㱿㲄㲉㷤㺉䍍䐨嗀彀愨榖殻殼(慤)毂瑴瞉穀(濲瀔)糓縠(瀫)螜觳豰轂鷇
壳	壳悫𠳗𢭜𨧣𩩬
㳄	㳄
羨	㵪䢭檨羡羨𥖄
㸒	㸒婬𡍛𣓆𣨮𦲻𨂘
淫	淫滛霪(𢺓)𢴏𤎛𦹻
䀠	㪺䀠愳𣰋
䍃	䁘䌊䍃䔄䠛䬙傜嗂媱徭愮暚榣熎猺磘窰繇(㒡㘥櫾蘨)鎐颻鰩鷂
[⿱爫缶]	摇瑶謡谣遥飖鳐鹞𡏟𡩴
[⿱肉缶]	搖(𩆋)瑤(𤁓)謠遙(𤁠𦾾𩆡)
䏌	㞕䏌佾洕
䖒	㱆䖒覻𢶐
戲	㚀㸍㺣嚱巇戲隵
戏	戏
䙴	䙴僊褼蹮𦒘
遷	䉦櫏躚遷韆𫾔
䜌	㝈㡩㪻㱍㽋䘎䜌圝奱孌孿巒彎(壪灣)戀(㜻纞𤼣)攣(䖂癴)曫欒(圞灤虊)灓矕羉臠(癵)蠻(䂅𢺳𥾃𧖣)變(𡔖𤅶𤓩𥘂𨰺)鑾鵉鸞𨏶𨷻
[⿱亠⿲丶⿰丨丨丶]	变(𡍣𣷷𤊰)娈孪峦弯(塆湾)恋挛栾(滦)脔蛮(𧅬)銮鸾
䧹	䧹噟應(𥌾𧃽)膺譍鷹(𪈾)鹰
应	应
䨿	㒎㗺㩑㪪䙣䨿
䪞	䪞𠎷𢶍𨆂
䩗	䩗
一	一弌
丁	㐉㓅㼗䆑䟓䦺丁仃(𠯼𣫲)厅叮圢奵帄庁忊打(咑)朾汀灯玎町甼疔盯矴糽耓耵艼虰訂(𢱏)订邒酊釘钉靪頂(㴿嵿𠽒)顶飣饤
丂	㱙㽲丂攷朽
巧	㚽㤍䲾巧窍𢫚𤇤𥿣𧊌𨥿
七	㲺(柒)七𠮟𨳍
万	万劢疠虿迈(𨒒)𬇕
厉	䥿励厉栃砺粝蛎
丈	㽴丈仗扙杖𠀋𢗆
三	㭅三仨叁(𦲞)叄弎閆闫
上	䒙丄上仩圵让𨑗𬉷
下	丅下乤吓忑疜芐虾雫𨑜
不	㳅㶨䞜䬪䯱不伓吥囨妚抔杯炋紑罘肧衃鈈钚阫鴀
盃	㮎盃𠸟𢝙𣡝𤠅𥔦𦞑
芣	芣𠶙𢯒𣔟𥟼
[不1]	坏怀
与	与屿欤玙𥫣
丏	䞛丏汅沔眄(㴐)髩麪𢚽
丐	丐鈣钙𠰁𡛔𥝽𩬆
匃	匃匄
丑	㞪(䛝峱)㺲䂇䏔䖡䚼䶊丑丒吜妞忸(𠴐𦁁𦛾)扭杻橻沑炄狃(莥)粈紐纽羞(䡭饈馐鱃)衄鈕钮靵𧘥
且	㚗㡹㸖䏣䔘䖕䢐䢸䣯䪶䱉且伹俎(葅)刞咀坥姐岨徂(䓚)怚抯柤殂(𣹖)沮(䈌菹)狙珇疽砠祖(䔃𡏄𣗿𤍄)租(蒩)笡粗組组罝耝苴(䃊)蛆袓詛诅豠趄跙鉏阻(唨)雎靻飷駔驵鴡麆齟龃𩗃𪗱
虘	㜘㢒㪥䁦䠡䣜䶥摣樝皻蔖虘覰謯齇𪓐
助	助筯耡莇鋤(㐥)锄𢄂𤞩
丕	㚰㺽䋔䪹䲹丕伾呸噽坯岯怌抷柸狉秠胚苤蚽豾邳鉟駓髬魾𣆏𣌹𤇨𨸹𬳵
㔻	㔻䮆銔
世	㔺㰥䄁世丗伳呭屉屜怈抴枻泄玴疶笹紲绁袣詍貰(勩)贳(勚)跇迣鉪靾髰齛
卋	卋
丘	㐀㚱㳋䟬丘丠坵岴拞蚯邱駈𠰋𥬨𥿤𩨼𩿨
丙	㑂㶮丙怲抦昞昺柄炳病眪窉苪蛃邴鈵陃𠰳𡛦𤖶(寎)𥹘𧦿𨋣𩛄𬇞
並	䗒䰃並掽椪湴碰踫𡖼𡴢
竝	傡竝𩄳
丨	丨
丩	㧃㸨㺩㽱䡂䤛丩嘂朻糾纠舏虬虯觓訆赳鼼
叫	䆗叫呌𠲠𢫃𣌺𣐲𨦀
收	收荍𦀏𩷊
个	个𠮶
亇	亇𩵜
丫	丫吖
中	㞲㲴䆔中仲(㳞筗茽)冲妕忠(㥙)忡(浺)沖狆盅祌种翀肿舯蚛衶衷鈡钟𣐄𦬕
丮	丮
丯	丯
丰	㕩㭋䂜䒠䰷丰仹妦沣炐玤盽肨蚌𡵞
丱	丱
卝	卝
串	串梙賗鋛𠁺𦀵
患	䍺䗭䜨患槵漶瞣贃
窜	撺窜蹿镩
丸	㿪䀓䴟丸奿汍紈纨肒芄骫𡉕𡚺𣏒
丹	䒟䢷䵊丹刐坍(㳩)旃(㮵栴)枬玬砃袇鴅鿕𨱪
丶	丶
主	㹥䇠(樦)䝬䪒主住(𥇁)妵宔拄柱(㴤嵀)殶注(㗟乼霔)炷疰砫紸罜蛀註跓軴迬鉒飳駐驻麈黈(蘣)𠰍𡊲𤖸𦭦𪐴
丽	㛤丽俪婯彨逦郦酾骊鲡鹂
丿	丿
乀	乀
乂	㣻㲼䖊䢃乂刈(苅)
艾	㘷哎砹艾銰餀鴱𤈝𥐋
乃	㭁㲌䄧䚮䯮乃仍(㺱芿(㗡)𠯹)奶扔氖疓礽艿(莻)辸釢鼐𠄎𠮨𢖱𣅅𣱽𤆈𤜠𥾋𧈣
久	㝌㡱久乆匛(柩)奺杦汣灸玖畂疚粂羑(㕗湵)镹𨥆
乇	㡯(䅊侂)乇仛厇吒(䆛𤕔)圫奼(䒲)托(𡱩𢫅𢭑)杔汑(𣴜)灹矺䂝秅(㢉)籷虴託(㓃𣘄𣨰)讬飥饦馲魠
宅	㤞䖳䤩䯔侘咤垞姹宅挓烢秺詫诧𥭌
之	之芝
妛	妛
旹	峕旹
㞢	㞢
乍	㡸㸲䋏䝫䞢䟭䩆乍作(㤰宱筰莋𠴚𤉔)厏(𧨊)咋妰岝岞怍怎拃昨(葃)柞泎炸痄砟祚(𨃼)秨窄(搾榨醡鿽)笮胙(葄𨐷)舴苲蚱詐(𠁙)诈迮酢鈼阼飵鮓鲊齚𩿞
做	做
乎	㭔䉿䤣䴣乎乥乯呼垀泘烀苸軤轷雽𠇼𧦝
乏	㞏䍇䒦(㴀𦹴)䟪乏姂抸柉泛(𣓦𥁷)疺眨砭(𠻅𦷩)窆覂貶(𠍥𠹰𢵉𧒅)贬鴔𠇖𠰏𣭛𤇮𤝑𦚖(𠸾)𧊉𩬪𩶟𪀐
众	众
㐺	㐺
乑	乑
乖	㔞㪓㾩䂷䓙乖𡇸𡮓𢮿
乘	乘剩塖嵊椉溗騬
乗	乗剰
乙	㲸乙亿忆穵(挖)肊艺(呓)釔钇鳦𠃣𠃮𠃯𠃷𡴭𡴯(𦙏)𢖮𢩧𣎷𤴥𥝎𦨇𧰦𩁶
乚	䰲䵝乚乩劜圠扎(紥)耴軋(錷)轧
札	㳐札紮蚻𢫄𣑌𩿤
九	㐇㐜㐤㕤㭝䊵䜪䧱䲥九亴仇(㖌𠯾)勼(䬨)厹叴宄尻(㘲䯌泦髛)扏旭(𢬐)朹氿犰究(㙀)肍艽芁虓(婋猇)訄訅軌(匭)轨(匦)釚頄馗鳩鸠鼽𨳊
乞	㩿㫓䇄䎢䒗䞘䢀䦍䩐䬣䰴乞仡刉吃圪屹忔扢杚汔犵疙盵矻籺紇纥肐虼訖(𤍋)讫趷迄釳阣麧齕龁𠖯𩠓
也	㦾䄬䊶䪧䶔也乸他匜吔地(哋𡜤𥒦)她弛彵忚扡杝毑池(筂𠲨𨦥)灺牠祂竾肔虵衪訑貤迆酏釶阤馳驰髢𥐨𦏸
㐌	㐌㢮䝯拖柂炧狏粚絁胣袘迤鉇陁駞𢘬
乳	㐠㳶乳啂𡝦𡮈𢯚𥇽𥯇𦜘𨼼
[⿳爫⿳龴冂厶又]	覙覶覼
亂	亂薍
乱	乱
了	㝋䄦䑠了疗辽釕钌𠖭𠮩𢩪𣱾𤽀𧾿
予	㐨㘧㜿㮊(壄)㶦䂊䂛䦽予伃妤序(垿𢭸)忬抒杼汿紓纾芧豫(櫲)野(嘢墅𣼫)預(澦蕷𠟹𨮌)预(滪蓣)魣
事	䭄亊事倳剚𠶝𢜝
二	二
弍	弍弐𠱌
貳	㒃㦐㹑樲膩貳
贰	腻贰
于	㐵㚥㝼㡰㪀㽳䄨䍂䏏䩒于吁(冔)圩宇(䢓𠱶𨦦)扜旴杅汙(䨕䵦盓窏𧋂)玗盂(䣿)盱穻竽紆纡芋虶衧訏趶迂邘酑釪骬𠃗𠄀𤿍𩁹𬣙
亏	㺮䊸亏亐圬扝杇汚污疞肟芌迃釫𣏓
云	䢵䰟䲰云伝呍囩夽妘忶抎枟沄眃秐紜纭耘(𦶮)耺芸転(𫝚)运酝魂(𡂃𡄬)
雲	䉙墵橒澐繧蕓雲𡢅
互	䇘䊺互仾冱弖枑沍魱𦊂
㸦	㸦𠖱
五	㐏㕶五伍忢𥄬
井	㘫䎴井坓妌宑汫汬穽肼阱
进	琎进
[井]	㓝畊耕
讲	讲
[开]	㼛形(䤯)邢鈃钘
刑	㣜㭢侀刑型硎荆荊鉶铏
丼	丼
亖	亖
亘	䚙亘咺垣峘暅桓洹烜狟絙荁貆
亙	㔰䱍亙恆(㮓䱭堩揯緪)絚𨀿
[亘]	䱎刯姮恒(䱴搄縆𠷐)𠡚𢬎
亞	㝞㰳䃁䛩䢝亞俹啞埡堊婭孲掗(𠻺)椏氬琧瘂稏蝁錏鵶𣵾𤦩𦜖
惡	䜑僫噁惡癋鐚𥼳𦠲𦼇𨉼𪅴
亜	亜唖
悪	悪
亚	䅉亚哑垩垭娅挜桠氩痖铔
恶	恶𫫇
亟	㥛䓧䩯亟極(𨅰)殛焏
亡	㠵䖟䰶亡吂妄(𤥑𥿺𨦩)忘(莣)忙朚望(𥊛)杗杧氓汒(茫𥭎)牤甿盲(䈍䗈)盳笀肓虻蝱(䥰)衁邙釯𠺯
芒	㟐䅒恾硭芒鋩铓𠴏𡙧𣒣𤞽𤶼𥇀𥭶𦀴𦛿𧋽𩓜𩷶
巟	㡆㤺䀮巟
荒	㡛㬻㼹䐠塃慌荒謊谎𠻄𤠤𩺊
亾	㠩㡃亾詤
兦	㤀兦
亢	㰠㼚㽘䋁䘕䟘䡉䭺䲳䴚亢伉劥匟吭囥坑妔忼抗斻杭(𠵉)沆炕牨犺砊秔笐粇肮航苀蚢貥迒邟鈧钪閌闶阬頏颃骯魧
交	㝔㬵㼎㿰䂭䍊䘨䢒䴔交佼効(俲)咬姣峧恔挍效(傚滧)晈校洨烄狡珓皎窔(𢲷)筊絞绞胶茭虠蛟詨跤較较郊鉸铰頝(纐)餃饺駮(礮)骹(䉰䕧)鮫鲛鵁齩
亥	㐪㚊㤥㧡㱾䀭䠹䤤䬵亥侅刻劾咳垓奒姟孩(𢱙)峐晐核欬氦烗畡痎硋絯胲荄(𠹽𢲧𣘃𤼞𦃮𦟍𨐮𨢟)該(𡀲)该豥賅賌赅輆郂閡阂陔頦颏餩駭骇骸𨠳
亦	㑊亦亪奕(㷜湙)帟弈(㴒)洂硛脔𠲔𢙕𩷉𪁂
亨	㧸亨哼悙梈涥烹(䥋𢴒)脝
享	享
亯	亯
京	㹁䁁䃄䝶䣼京倞凉剠勍婛弶惊掠晾椋涼(𡰏)猄(𢠃)琼綡翞諒谅輬辌鍄鯨鲸鶁麖黥𠶛𡌿𡹞𡹡𨂙𫟅
亰	亰鿌
亮	亮喨湸
景	㔀䭘幜影(𡂵)憬撔景暻澋璟鐛𠎠𠾶𥋓𩐿𪆣
㬌	㬌
亭	㷚䁎亭停(𠏦𠼵)婷嵉揨楟渟碠聤葶蝏諪𠷥𢝜𥪜𦂃
亶	㔊㣶䁴䃪䄠䆄䉡䕊䡀亶儃勯壇嬗憻擅旜檀氈氊澶璮皽繵羶膻蟺(灗)襢譠邅顫颤饘驙鱣鳣鸇鹯𨲷𫗴
坛	坛
人	㕥人朲秂认魜
仁	仁佞忈芢𣏴𣲚𥄰
亼	亼
今	㕂㪁㲐䑤䩂䪩䰼䶃䶖今仱吟(荶𣵴𥆽𦛽𪑑)坅妗岑岒庈忴扲昑枔棽欦汵玪琴(䔷噖𦠴)砛笒紟耹肣芩衾(搇𠹸)衿(𠸐)訡赺趻軡鈐(𤪊)钤雂霒靲鳹鹶黅黔𥄯𩠻
介	㖋㖎㜾㝏㠹㰡䚸䦇䦏䯰䲸介价吤圿妎尬岕庎忦扴斺炌玠畍疥砎祄紒芥(𠶋(𦄶))蚧衸阶骱魀魪齘𬹼
界	䛺堺楐琾界畍鎅𠝹𤋽𤲂𨺬
仌	㓈仌冫
冰	冰栤氷砯𢬄𦀋𨀰
馮	㵗凴慿憑馮
冯	冯
凭	凭
从	丛从怂枞疭纵耸苁
付	㖚㤔㾈䂤䑧䠵䵾付咐坿姇弣怤拊柎泭祔符(䒀)紨胕苻蚹袝詂跗軵鉜附(䮛)駙驸鮒鲋𡧛
府	俯府捬椨焤腐腑
仙	仙仚苮
代	㭖䒫代垈岱帒柋玳蚮袋貸(蟘)贷鮘鴏黛𠁀𠰺𢂌𢫙𦨮𩂠
令	㡵㱓㲆㸳㾉䍅䠲䯍令伶(𠴒)冷(唥𣇝)刢呤囹坽姈岭岺彾怜拎旍昤朎柃泠(霗)炩狑玲瓴皊矜砱秢竛笭紷羚翎聆(䉁)舲苓(𡅐𣉏𤋶𨩖)蛉袊詅跉軨邻鈴铃閝阾領(䕘嶺𦆺)领駖魿鴒鸰鹷齡齢龄𠖝
零	㩕㬡㯪䌢䙥䴇䴫澪燯蕶零
命	命掵椧𠴠𠵴𦁸𨉟
件	件
任	㤛㳝㶵䇮䋕䛘䣸任姙恁拰栠栣秹絍荏袵賃(𠿹)赁銋餁鵀𠄶𠲏𤞘𤶄𥆂𨠲
企	㖉企峜𨀣
伊	伊咿洢蛜𢙬𦭽
伏	䟮伏垘栿洑絥茯袱覄
伐	㘺䣹伐垡栰浌筏(𦠱)茷閥阀𢬩
休	㳜㹯㾋䏫䛙䮌休咻庥恘恷烋烌茠貅銝髤髹鵂鸺
位	位涖(蒞)莅𠴖𡸏
余	㻌䋡䍱䞮䟻䣄䩣䳜余俆凃(𡍼)叙(溆)唋峹嵞庩徐(蒣𣉹𣻄)悆悇捈敍(潊)敘(漵)斜(㙦䔑厁)梌涂(塗蒤)狳畬(𦼞)畭硢稌筡艅蜍途酴雓餘(𧃋)馀駼鮽鵌𠄜𣇞𤫿𤬀𥚤𥥸𬳿
荼	䅷瑹荼鷋𠻬𢴉𣘻𩻓
茶	嗏搽茶𣗪(𡁽)𤯊𥻹𦓅𨃓𪄦
佘	佘畲賒赊𦯬𦾠
佩	㧩䊃佩姵珮
侃	侃偘諐
來	㾢䅘䋱䚅䚞來倈勑唻(𢴙)婡崍庲徠斄棶淶猍琜睞箂萊(𢵭𨅼)誺賚逨郲錸顂騋鯠鶆𢜞𢯦𣛤𤀛𦠘𧼛𨂐𩳳麳𪘨
来	俫崃徕来梾涞睐莱赉铼𣑎𣘾𪎌
麥	䥑䨫䮮嘜麥𪄳
麦	唛麦鿏鿺
侌	侌霠
陰	廕癊蔭(𡓅𨯛)陰𠽛𣼩
隂	䕃隂
阴	荫阴
侖	㖮㫻㷍䈁䑳侖倫(溣𠹹𨫅)圇埨婨崘崙(磮𢳳𣜱𣼍𦟹)惀掄棆淪睔碖稐綸耣腀菕蜦論踚輪錀陯鯩𠁄𠓹𠓻𡃋𡈺𢀧𢜒𣗾𣘈𧛈𧷺𧹪
仑	㓆仑伦囵抡沦纶论轮𫭢𬬭𰗖
侯	㑨㢿㬋㮢䂉䗔䙈䞀䫛䳧侯候(𤠣)喉堠帿猴瘊睺篌糇緱缑翭葔鄇鍭餱鯸𤬈𬭤
矦	㗋㺅矦
[⿳𫜹冖又]	㓎㾛䘲䜷䯹唚埐寝寢梫濅祲綅薓誛鋟锓駸骎鮼𥺑𨡉
侵	䈜侵寑葠𠸬𣋨𨃏𩮕
浸	䆮寖浸蓡𠺸𢟖
便	㛹便楩箯緶缏鞭鯾
保	㨐䭋䳰保堡堢媬宲椺煲緥葆藵裒褒褓襃賲𠸒
俞	㓱㡏㢏㺄㼶䃋䄖䜽䠼䤅䩱䬔䵉俞偷匬喻堬媮崳嵛愈(癒𢷀𣜴𤀒𥣒𦾤𨮋𩙍)愉揄榆(䕆)歈毹渝(蕍)牏瑜瘉睮窬緰羭腧萮蝓褕覦觎諭谕貐踰輸输逾(𩙋)鄃鍮隃騟𣈥𣈯𤭷𧱬𩜶
兪	偸兪喩婾楡毺
信	信
倉	䅮䢢䤌䱽仺倉傖凔創(𣋃𤏬𦼃)嗆嵢愴戧搶槍滄熗牄獊瑲瘡篬艙蒼(濸)螥謒賶蹌鎗鶬
仓	䲝仓伧创呛怆戗抢枪沧炝玱疮舱苍跄鸧
倝	㲦䮧乾(㨴墘漧𠼳𢠥)倝幹(擀檊澣簳𦼮)斡(濣)榦翰(瀚)螒雗韓韩(鿰)鶾𤃬
傘	傘
伞	伞
仐	仐
[⿱至用]	㑲㣁㸢備(㷶憊𡀠)僃犕糒鞴韛𠻋𡢼𢊑𥡘
备	俻备惫𡞕𥓶
[⿱冃羽]	㲩䈳䌈䑽䪚傝塌搨榻毾溻禢褟蹋遢鎉闒(躢)阘鰨鳎
僉	㷿㿌䌞䩎䲓䶨僉儉(𢸟𨇓𨯘)劍劒劔厱噞嬐嶮憸撿(籡)斂(瀲籢蘞𤒦)檢歛(㶑籨蘝𡄥𢹦𣌋𨰇)殮澰獫瞼礆簽(䊴𣠺)羷臉薟襝譣醶鐱險顩驗鹼𭺷
佥	佥俭剑崄捡敛(潋蔹)检殓猃睑硷签脸莶裣险验
㑒	㑒㪘㰸倹検険鹸𡸴𢮦𥇥𫠗
匳	匳
奩	匲奩檶
奁	奁
𧶠	䄣䢱儥凟匵嬻櫝殰瀆牘犢瓄皾竇(𡔍)續藚襩覿讀讟豄贕贖鑟韇韥黷𡂝𡔍𧶠
[卖]	㱩椟渎牍犊窦续觌读赎黩
[売]	㸿涜続読
兀	㐳䑢兀卼屼扤杌矹虺豗軏(𤍆)阢靰髡鼿𠮾𡵉(𤈡)𣲍𣾃𤮾𤮿𨓢𩂁𫐄
允	㭇㽙䆓䦾允吮抁沇狁玧鈗阭馻𨋍
兂	兂
元	㐾㝴㪴䏓䛃䦎䬧䯈䲮䲶元冠(蒄)刓园坃妧岏忨抏朊杬沅玩(𠶃)盶笎翫芫(𢯥)蚖衏貦远(䓕)邧阮(𠴉𢭫𦰟(𢴝))頑(㹕)顽髡魭黿鼋𠰂
兄	㑆㚾㫛兄况岲怳況炾眖貺贶軦𧚢
充	㓍㤝㧤㳘䘪䟲充珫統(𥴗𦼟𨭑)綂(𥽄)统(𡎭)茺銃(𧀏)铳𩩇𪁇
兆	㸠䂪䄻䍮䑬䠷佻兆咷垗姚(𢱐)宨庣恌挑(𨃑)旐晀晁(𩺣)朓桃洮烑狣珧眺祧窕筄(艞)絩罀聎脁覜誂趒跳逃銚铫雿鞉頫餆駣鮡鼗𡭰𢬹𣑯𫖯
先	㧥㪇㭠㮱㰫㱡㾌䊁䚚䢾侁先兟冼姺宪毨洗(箲鍌𢝚𢱓)烍珗筅詵诜跣选酰銑铣駪𠒷𠜎𠸛𠸜𢏡𤞓𥏋𥏌𨴐𬳽
光	㘢㶢㹰㿠䯑侊光咣垙姯恍(𦞔)挄晄桄洸灮炗炛烡珖硄絖胱茪觥輄銧駫𢩊𣆥𤈛𤶏𥆄𦨻𧧯𧵦𨐈𨒺𨠵𪀯
晃	㨪䁜幌愰晃榥滉熀縨鎤
克	克剋勀勊娔尅氪𠳭𢭪
[兌]	㙂㟋䂱䫄䬈䬽侻(䓲)哾娧帨痥祱綐莌裞駾鮵𥆟
兌	兌悅挩敓梲涗稅(𠾔)脫(𢴎)蛻說(𡁾)銳閱
兑	䌼兑悦捝敚棁涚税脱蜕説说鋭锐閲阅
兊	㣞兊恱毤
免	㝃㡈㻊䅋䨲俛免冕(𨬋)勉(㛯葂𠷦𣈳)娩(嬎)悗挽晚梚浼睌絻脕莬輓鋔鞔鮸𣆶𩾃
兒	㪒䋩䍲䘽䮘倪兒唲堄婗掜晲棿淣猊睨腉蜺觬誽貎輗郳霓鯢鲵鶂鶃麑齯𡮅𡸣𨺙𫀗𫐐𫠜
儿	儿
児	児𥆩
兓	兓
鬵	灊鬵
兔	㭸䖘免兎兔堍婏梚菟鵵𤟛𫟏
㲋	㲋
兜	㨮兜篼蔸𦄓
㿡	㿡
兠	兠橷
兢	兢殑
入	㐈入叺圦扖杁鳰𣱿𥃱
[內]	㐻㕯(𦛚)㘨㶧䄲䟜䪏妠抐枘氝汭笍納(㨥䈫𠌦𠖘𠺶𢟕𣘆蒳𣻀𥧩𥻻𨃺𩄵)肭芮(㨅焫蜹𡍝𨧨)蚋衲訥(𠽆𤹽𦄠)豽軜鈉靹魶𢗉
內	內吶
内	内呐纳讷钠𡶀(𦀼𨁧)𤬲
全	㒰㓌㻇䀬佺全姾峑恮拴栓洤烇牷痊硂筌(𣛩)絟荃詮诠跧輇辁醛銓铨駩
兩	㒳㔝䓣䠃䩫倆兩啢掚緉脼蜽裲輛魎𦑅
两	两俩唡辆魉
両	両輌𠈓
八	䒔仈八叭扒(𤁙)朳汃玐趴釟𣼪𤴭𥐙𦘩
公	㒶㕬㝐䇗䚗䡆䯳䰸䲲伀公妐彸忪枀枩炂玜瓮蚣衳訟(𦄸)讼鈆頌颂𣌶𦰠
六	六
兮	㿽(諡)䒊䚷兮枍盻肸𠯋𡕵𢇱𤵕𥬋
共	㓋㤨㬴㭟㳟䀧䜤䢼䧆䱋䳍供(䣏𥯏)共哄垬娂恭(塨)拱拲晎栱洪(篊葓鍙霟𢝳𥈰𬮍)烘珙硔粠舼蕻蛬衖谼輁輂(檋)鉷閧髸鬨龔龚鿁𠧆𢩉𤞒𧋄𧶯𩐠𫟹
巷	㟟塂巷港𨃈
兵	㑟㙃兵娦捠梹浜鋲鬂𦛼
宾	㺍傧嫔宾摈槟殡滨瑸缤膑镔髌鬓
乒	乒
乓	乓
其	㐞㠱㥍㫷䃆䑴䫏䳢䶞倛其剘唭基(䥓樭璂禥簊𠼻𦸀)娸帺惎掑旗(簱籏)朞期棊(㯦)棋(簯)欺(㠌僛𠿁𡮪)淇猉琪碁祺稘箕(檱𡒬𥶂𦪵)粸綦(櫀濝藄𤪌)綨萁蜝蜞褀諅諆踑錤騏骐魌鯕麒𣈒𤊄𤻓𦓿𧯯𨡨𫓹
具	㖵㮂䋰䡞俱具埧惧椇犋颶飓𢮭𦩛𨍄
典	㙉㥏䐌䓦䠄倎典唺婰捵敟晪椣淟猠琠痶睓碘腆覥觍賟錪𦥃𧌎
[茲]	㽧䈘嗞嵫慈(㘂䗹嬨濨礠)滋甆禌稵糍螆鎡鰦鶿鷀𩝐
茲	孶玆茲𥔵茊
兹	兹孳磁镃鹚
兼	㝺㡘㪠㺌㻩㼓㽐㾾䁠䈴䫡䭑䯡傔兼嗛嫌(𥽎)尲嵰慊搛槏歉溓熑甉磏稴縑缣膁蒹螊謙(𡄫)谦豏賺赚鎌隒馦鬑魐鰜鳒鶼鹣鹻鼸𠁟𡗄𢐎𥡝𥻧𨃰𪙊
冀	䆊兾冀懻驥骥𥜥
冂	冂
冃	㧇冃
冉	㘱(㴂)㫋㾆䎃䏥䤡䫇䶲冉呥姌抩柟珃畘聃(䔜𢳞)舑苒蚺袡髯𣲹𤝫
冄	㚩䑙䒣䛁冄枏耼蚦衻髥𡖔
[冊]	笧粣
冊	冊柵
册	册栅
冋	㢠㺾䌹䯧冋坰扃泂炯絅苘詗诇迥(𣔲𣹔)駉𬳶
再	侢再洅𢈖𤞕𦛍𧋁
冎	冎
冏	㓏㤯䢛䮐冏埛浻烱綗
冒	㡌㪞㴘䑵冐冒勖勗媢帽朂毷瑁艒萺蝐賵赗
冓	㗕㝤㡚䃓䐟傋冓媾搆(簼)斠構(𡒫)溝煹篝耩褠覯觏講(𡄧)購遘鞲韝顜𤠰
冖	冖冟鼏
冗	䢆冗坈棾
宂	䢇宂
[宂]	抭狖貁
冘	㓄㕪㱽㶩㼉㽎㽸䏙䒞䧵䪴䶻冘妉帎忱抌(𠜭)枕(萙𠶍𡹟)沈(莐霃𠴥𢭽𤉠)沊瓭眈紞耽(㴷𢲠𧏰𨄁)衴訦躭邥酖(𩻕)醓鈂馾髧魫鴆鸩黕
[冗]	㕴㚮䤟伔沉
冡	䥂䴿冡塜溕霥
冤	冤蒬𣍍
寃	䥉寃
冥	㝠㟰㨠䄙䆩䈿䏃䒌䫤冥凕塓嫇幂幎慏暝榠溟熐猽瞑蓂螟覭鄍
冬	㐑㚵㠽㣠㤏㫡㲇㹣䂢䧷䳉䶱佟冬咚峂庝昸柊氡泈炵疼笗終(䈺蔠𡈡𢴋𤍑𨄿)终苳螽鉖鮗鴤鼕鼨鿴𢫝𣁲𨀐𨒟𩂓𩢦
几	㞦㲹䘛䢳几叽机玑矶肌虮讥飢(㔳)饥麂
凡	㕨㞩䏎䭵凡凨帆忛杋梵(滼)汎(盕)矾竼舤舧芃(𢭾𣒾𥟌)訉軓釩钒𠆩𠔮𡴉
凢	㠶凢凣𢖾𥐥
鳳	鳳
凤	凤
凵	㧄凵
凶	㓙㕳凶忷汹訩讻酗𣧑
匈	匈哅恟洶胷(𤭶)胸(𡏠)詾𤈤𦭪
兇	㟅䣴兇𩷇
凷	凷
屆	屆
届	届
出	㑁㒴㔘㞮㤕㽾䂐䖦䢺䪼䭯出咄岀拙(𠶯𡮍𢮬𦵛)柮欪泏炪础窋笜絀绌聉胐茁(𢱝𣖠𣙸𤋿)袦詘诎貀趉鈯飿饳黜𠀴𡭧𡭱𡭲𧿺
函	㖤㮀䈄䘶䤴䨡函崡涵菡蜬顄
圅	㮭䓿䥁圅
凾	㴠凾
刀	㧅䚯䫸䬢刀刂叨(䬭)忉旫朷灱灲舠芀虭辺釖釗钊魛鱽鳭𣱼𤴬
刁	䒒刁叼汈
刃	㠴㣼㲽䀔䵑仞刃屻岃扨杒牣紉纫肕訒讱軔轫釰靭韌韧
忍	㸾䏰忍梕涊荵認𠴍𢚴𢭝𥆾𥊟𥚆𨧟𨲅
刄	仭刄釼靱
刅	刅刱剏剙梁(墚樑)粱
分	㞣㤋㸮䭻份兺分吩哛坋坌妢岎帉弅忿(𦝅)扮攽昐朌枌梤棻(㯣)棼椕氛汾炃玢瓫盆(㖹湓葐𡎛𢞂𢱔)盼砏秎粉(㥹)紛(蒶)纷羒翂聁肦芬蚠蚡衯訜貧(𢠈)贫邠酚鈖雰頒颁馚魵鳻黺鼢𥽡𦯀
切	䀙䟙切彻沏砌窃苆袃𠯦𢗠𣐆𤆻𥾛𩚦
列	㡂㤠㤡㽝㾐䅀䮋䴕䶛例(𠅜𡂲𣈙𥵘)冽列劽咧姴峛峢挒栵洌烈(𠗹𢟏𤍅𤹐𥉬𦃾𦤭𧏲𨃻𩄰)茢蛚裂趔迾銐颲鮤鴷鿞𠞺𥆁𦀎𧍐𨀺𨦙𩂶
初	初𠸗𢮀𦁅
[別]	㭭䇷䤢哵捌莂
别	别𠣶𡌀𤿱𥇂𦖇𦛺𨡊𨧢
別	別
利	㓿㥎䂰䊍䖽䖿䬆䱘䴻䵩俐利剓唎娳峲悡悧梨(䔧蟍鏫𠼝𣗱)梸棃(蔾)浰犁(䔣)犂(𦺙)猁琍痢睝筣脷莉菞蜊鋓鋫錅鬁鯏鯬鵹黧鿟鿠𢈱𪏭
黎	㠟㰀䉫䵓嚟瓈藜邌鑗黎𠠍𤂱𤑬𥌛𥗍
[刪]	䈀狦珊跚𦙱
刪	刪姍
删	删姗
到	倒(𨃫)到捯椡箌菿𠴼
制	㫼䎺䱥制掣淛猘痸製鯯𠶜𡍘𢮓𨔈𨨪
則	䈟䶡側則厠崱廁惻測萴鍘鰂𡬷𣖡
则	侧则厕恻测荝铡鲗
剌	㻝䏀䓶䱫剌喇揦揧楋溂瘌蝲辢鬎鯻鵣𬶟
辣	辣𣋩𤁕𤻬𥶁𨆹
前	㡐㮍㷙偂前媊揃椾湔煎(𢶕𣜭𤐄)瑐箭(擶櫤𢤣)糋翦(譾)葥鎆騚鬋
剪	㨵剪彅(𦿶)謭谫
劉	䉧䬟劉嚠嬼懰瀏藰
刘	刘浏
力	㔕㔹䡃䣦仂力劤劧劯叻屴忇扐朸氻牞玏竻肋艻赲阞(泐)鳨𠡏
历	历呖坜枥沥疬苈雳𫵷
加	㔔㔖㖙㚳㤎㧝㹢䂟䪪䴥乫伽加咖哿嘉(䕒)妿拁架(㗎𢱌𣕧)枷毠泇珈痂(瘸)笳耞茄(𠸏𡲢𣖚𨔽)袈賀(㵑𧬂)贺跏迦鉫駕(𡃉)驾鴐鿼𡶐𥑆𩶛
劣	㭞劣挘𩷈
劦	㶸䅄䝱(燲)䬅劦勰協姭恊拹栛珕脅(㙝嗋愶搚熁)荔蛠𣴚
[办]	协胁
助	助筯耡鋤锄
勞	䜎䲏僗勞嘮嶗憥憦撈朥橯澇癆磱簩耮蟧軂鐒髝𤏪𤩂
劳	劳唠崂捞涝痨耢铹鿲𣓿𦛨𫭼
労	労𢭐
[𤇾]	䃕䝁犖膋
[⿱艹冖2]	䒿荦
勺	㢩㣿䂆䄪䋤䪨䵠䶂仢勺圴妁尥彴扚杓汋灼(䓎)犳玓瓝的(啲菂𢯊𤷭(𦗽)𦖡𦝂)礿約(喲箹葯)约(哟药)肑芍(烵)虳訋豹趵酌釣(䔙瘹)钓靮馰魡𧺕
勿	㫚(㳷䐇匫曶)䀛䀜䝆䥼䴯伆刎勿匢吻囫圽岉昒歾沕物笏粅肳脗芴虝魩𢪥𢪱𧉚
[勹]	灳
[勻]	㚬䏛䝧伨呁均(筠荺鋆)抣昀枃汮畇盷笉蚐袀赹鈞(憌)韵
勻	䇖勻
匀	匀钧
勹	勹勽
包	㚿㯡䍖䎂䛌䮀䶌刨包匏咆垉孢庖(𠝇)怉抱(菢)枹泡(萢)炮炰爮狍玸瓟疱皰砲窇笣胞(𠷤)苞蚫袌袍跑軳鉋铇雹(㵡䥤)靤鞄颮飑飽饱骲髱鮑鲍麅麭齙龅𠓨𣭚𧲼
匊	㥌㹼㽤䕮䗇䜯䪕䱡匊婅掬椈毱淗粷菊(𣚭)諊趜踘躹鞠(巈蘜鞫驧)鵴麴麹龾𥮗𨨠
匋	䛬匋啕掏淘祹綯绹萄蜪裪醄鋾陶(𡒘)騊𫘦
匕	㠲䚰䣥匕庀朼牝疕
化	㐶化吪囮杹沎訛讹貨货鈋靴(㗾𢶤)魤𤆷
华	㟆华哗桦铧骅
花	㳸婲椛花蒊錵𠵅𢯘
𠤎	叱𠤎
北	䉾北苝軰邶鉳𢫣𨀈𨸾
𡿺	㑎㛴㺁匘堖惱(𢣈𦼝)瑙硇碯腦𡿺
㐫	㐫垴恼脑
匠	䞪匠
匡	㑌䒰䖱劻匡哐恇框洭眶筐誆诓軭邼𢬤𣃱𨀕
匸	匸
匚	匚
匹	䏘匹苉鴄
医	医悘(嫕)
匽	㰽䞁䤷偃(𠼸𪅬)匽堰愝揠椻蝘褗躽郾隁鰋鶠鼴𬸘
匿	㥾䁥䘌匿嫟慝(嬺)暱𠽋𢴚𣘗𤎐𦟻𧏾𩺱𪙛
區	䆰䌔䙔(䉱)䡱䧢䩽傴剾區嘔塸嫗嶇彄慪摳(𢷯)敺樞(䉩)櫙歐(䥲𡂿𤮥)毆漚熰甌瞘膒蓲謳貙軀醧鏂饇驅鰸鷗𣞃𤹪𥕥𦓇𨄅
区	䝙伛区呕妪岖怄抠枢欧殴沤瓯眍讴躯駆驱鸥𧦅𨸟𫭟𫸩𬉼
十	䦹什十卙叶旪汁計计針(𢟙𢲥𣗒𣻁𫠍)针
卂	㚨㭄䒖卂扟汛籸訊訙讯軐迅(䭀)阠𤣲
虱	虱蝨鯴鲺
千	䀒䊹䢴仟刋千吀圱圲奷忎忏扦杄歼汘纤芊谸迁(跹)釺钎阡𠉟𧿐𩵞
卅	卅
升	㐼㚈升呏抍斘昇(焺鵿𮢆)枡阩(陞陹)
午	㞰㬳仵午吘忤旿杵汻玝許(䔓滸𠼯𢠇𤾟)许(浒)迕𡉦𢨵𥄭𥘪𥾿𦬶𨳱
卉	卉泋芔𠱥𡜦
半	㪵㫠䉽䬳伴(𠴞𡖱𢭬𣵲𦁂)冸判半叛坢姅怑拌(𨉠)柈泮(𢯝)牉畔(溿)眫秚絆绊胖袢詊跘鉡靽頖𠦯𠰢𡭉𢏑𣫷𥐆𧉻𧸝
卌	卌
卑	㗗㪏㼰㽡䇑䚜䠋䡟䫌䰦䱝䴽俾卑啤埤婢崥庳(㯅螷蠯)捭(篺)朇椑渒(𥱼)焷牌(簰)猈琕痺睥碑稗(薭)箄(㵺)粺綼聛脾(簲)萆蜱裨諀豍郫錍陴鞞髀鵯鹎鼙𠜱𣈢
卒	㰵㱖㲞䘚䘹䚝䯿䱣倅卒啐(𨅇)埣崒崪悴捽晬椊淬焠猝琗瘁睟碎(𡀬𡳥𢣃𣩸𤻒)祽稡窣箤粹綷脺萃(㯜㵏膵)誶谇賥踤醉(𤂭)錊顇𠁸𠫏𠾹𡇻𡦧𡨧𡮇𡳝𣖛𣖢𣦮
卆	㳃伜卆忰枠疩砕粋紣酔𡉻
卓	㔬㪕㷹㹿䂽䈇䑲䮓倬卓啅婥悼(𨄵)掉(𦄹𧐼)晫桌(槕)棹(𥴙)淖焯(𦻐)琸窧竨綽(羄)繛绰罩(𥋽𥵙)趠踔逴鋽鵫𤙴𥇍𦠰𪂱
南	㑲㓓㣮䈒䊖䋻䌾南喃婻揇暔楠湳煵罱腩(𢷁)萳蝻諵𠄼𡎜𢆥𥈶𥠮𦣰𨂾𩄑𪻳
卜	㓀㺪䃼䟔仆(䇚𢪗𥾾)卜卟圤扑朴(烞)虲补訃讣赴釙钋鳪𢯜𣱶𥃨𦘱𧴤𨈒
卞	卞忭抃汴炞犿玣笇苄飰𠂪𠂫𥑃𥾽
卟	卟
占	㓠㚲㣌㤐䀡䍄䦓䩇䩞䪓䬯䴴䵿佔占呫坫(㼭)岾帖(㥈萜)怗战扂拈敁枮毡沾(惉霑)炶(𠸞)点(𨃊)煔(檆)玷痁砧秥站(𥱱)笘粘(𦟶)胋苫(𥠯)蒧蛅袩覘觇詀貼贴趈跕迠酟鉆钻阽頕颭飐鮎鲇黇黏點(嚸)𠛤𡖡𡖵𢇡𥎁𧮪𧲸𩬑
店	䛸店惦掂踮𠶧𡌽𣈔𣈘𣎀𥯎𧍈
卣	㔽䚃卣逌
卩	㔾卩卪
卬	䀚䒢䤝䩕䭹仰卬岇枊迎(𠶐𥈁𨓑)𢗾
昂	㭿昂𢯤
卯	㚹㡻㧕㶯乮卯夘奅峁戼昴柳泖珋窌笷聊(㗦㟹窷𣼾)茆貿(橮鄮)贸邜鉚铆飹駠𠰭𧖰𧖱𨥫𩊅
丣	䱖丣駵
印	䲟印抑(𠳑)茚鮣
危	㧪㩻䍯䣀䤥佹危卼垝姽尯峗峞恑桅洈硊祪脆蛫觤詭诡跪陒頠鮠𠱓𡳀𢼨𬱟𬶏
[卽]	㑡䐚䳭堲揤楖莭蝍鯽𪃹
即	即唧鲫
卽	卽喞皍
卵	㤻卵
卷	㒽䅚䊎䱧倦勌卷啳圈圏埢婘巻弮惓捲棬淃犈睠箞綣绻腃菤蔨蜷裷踡錈锩鬈𤷄
卸	䣃卸啣欫缷𨨶
[谷]	㞃䧍綌绤谻郤(㮝)
卻	卻腳
却	㑢㾡䖼却脚踋𠳞
𨚫	𠡺𨚫
卿	卿
厂	㕍厂厑屵鳫
雁	㷳贋赝軅雁𤎝𪆒
鴈	贗鴈𡃌
厃	厃
厄	㫉䝈伌厄呃扼枙砈苊蚅軛轭鈪阨頋𦙜𧦠
戹	㧖呝戹砨豟軶阸
厓	厓啀堐娾崕崖捱涯(𠽎𦹹)睚𠊎𣔦𦲒𧍊
㫗	㫗厚
原	㟲㟶㥳㹉䝠䴨傆原厡厵塬嫄愿(𨆸)榞源(𡀶𪒳)獂縓羱蒝螈謜豲願(𡅪𢥧)騵𠺿𫘪
厤	㷴㻺㽁厤磿𦀍
[⿸厂林]	暦歴(𤁋)
厥	㜧㵐䙠劂厥噘嶡嶥憠撅橛橜獗蕨蟨蟩蹶蹷鐝镢鱖鳜鷢𢅅
厭	㱘厭厴嚈壓(𢹥)嬮懕懨擪擫檿靨饜魘黶𥀬𧞣
厌	厌厣恹靥餍魇黡𦀫
压	压
圧	圧
厲	勵(䘈)厲巁曞櫔濿爄犡癘矋礪禲糲蠣鱱𡂖𧢝𩧃
厶	㺨厶私(俬)
厷	㢬䆖䍔䡌䧀䧺䫺厷吰汯竑紘纮翃耾肱谹鈜閎闳雄𡵓𦐌
厸	厸
去	㚎㧁㫢㭕㰦㾀䒧䟩䪺䮃佉厺去呿唟弆抾祛紶胠袪(𤹒)詓迲阹魼麮鼁𧉧
厽	厽垒絫(㒍𣚎)
叀	叀
參	㕘㜗㵕㺑㽩䟃䫩傪參叅嘇墋嵾慘摻曑槮毶毿滲犙瘮磣穇篸糝(𢹪)縿(𢹨)蔘謲贂遪醦鏒驂鬖黲𠔭𤗲𥊀𩅙
参	䅟参惨掺椮毵渗瘆碜糁骖黪𥮾
又	又
仅	仅
友	㕛伖友苃鿆𡛀
叉	㣾䂘䑡䟕叉扠杈汊(㳗)紁肞芆衩訍釵钗靫
及	㚫㠷㧀㽺䏜䑥䲯䶋伋及吸圾岋岌(𠲺𢚼𣵵𥆹)彶忣扱(𠳖)昅极汲砐笈級(𠺻𢲩)级芨衱觙訯趿鈒钑雭靸馺魥﨤𠀨𠄦𠍭𢪳𣌵𤆣𤜯𥄫𥝥𧲫𨸍
反	㤆㽹䛀䡊仮反坂岅扳(鋬)昄板汳炍版(蝂)瓪畈眅粄舨販(𢴔)贩返鈑钣阪飯饭魬𢆕𢓉𥯈𥾵𦙀𧿨
叔	㾥䱙俶叔埱婌寂(漃)惄掓椒淑(蔋)琡督(𧝴)菽裻諔踧錖𠴫
叕	㙍䄌䍳䝌䞵䟾䦤䫎䮕剟叕啜娺惙掇敠敪棳欼(歠)毲涰畷窡(䆯)綴缀罬腏蝃裰諁輟辍逫醊錣餟鵽𡨤𩸯
取	㖩㝡㷅㻓冣取埾娵娶掫棷棸樷箃緅菆諏诹趣郰鋷陬鯫鲰黀齱𤔛
叢	䕺叢
受	㖟㥅䛵受授涭綬绶𦈽
叚	㗇㰺䈔䠍䪗䫗假(𠽙)叚婽徦暇椵煆犌猳瑕瘕睱碬縀腵葭蝦豭貑赮遐(蕸)鍜霞(𡄟)騢鰕麚
叟	㛐㟬㥰㪢㮴㲣䏂傁叟嗖嫂(䕅)廋搜溲獀瘦(𩽉)瞍膄(㵻)艘蓃螋謏遚鄋醙鎪锼颼飕餿馊騪𫍲
叜	㛮(𦺋)䑹䗏䤹䩳䬒䮟叜廀摉
口	口叩扣(筘)釦𤘘𦬅
古	㐔㕆㖛㝒㱠㼋㽽䀇䀦䇢䊀䑩估古咕嘏姑(菇𢯐𦁿𧍏𪂯)岵怘怙故枯(喖𢉽𤋹𤚦𩹬)沽牯瓳盬祜秙罟苦(楛瘔𢱗𤋼)蛄詁诂跍軲(䉐)轱酤(䔯)鈷钴骷鴣鸪𠸙𡪻𡳰𢫈𤇌𥑮𦙶𦹯𦹵𧙖𩚩
句	㣘㲒㽛䅓䑦䝭䞤䣱䧁䪷䬲䵶佝劬句呴(喣)坸够夠姁岣怐拘(㐝)敂斪昫(煦)朐枸欨泃狗玽痀眗竘(䈮蒟𦵑)笱絇(𢳉)翑耇胊(葋)苟(㺃㻤𠸚𥰄)蚼袧訽豞豿跔軥邭鉤雊駒驹鮈鴝鸲鼩齁齣𢂁𪓟𫠚
勾	㘬勾抅构沟芶购鈎钩𡵺𥬉
叧	叧拐(箉)枴柺
只	㡶㰨䅩䍉䛊䳅伿只呮咫帜怾抧枳炽疻积织职胑识軹轵鉙齞𣲵𥿗𦭜𨈪𩿦
召	㐒㲈㸛䂏䎄䙼䧂䫿䬰佋刟劭卲召妱岧岹弨怊招(萔𠶅)昭(㷖照(燳𥵕)𡎣)柖欩沼(䈃菬𠶕𧍌)炤牊玿眧祒笤(𣙭)紹绍苕(鍣)蛁袑詔(𠾓𥴜𧝨)诏貂超(㯧𠾸𦠶)軺轺迢邵(綤)鉊鞀韶髫齠龆𠰉𠹾𠺥𡊱𡥙𢁾𤵪𥹙𦚔𪖠𬬿
可	㐓㞹㪃㪼㫊㰤㱒䋍䯊䶗可呵哿坷妸(𠶚)岢(碋)抲柯(樖)炣牁珂疴砢笴胢舸苛蚵袔訶诃跒軻轲酠鈳钶閜(㗿)魺鲄鴚𡥚(𠶄)𧙃𧯶
何	何哬𣒍
荷	嗬荷
河	河渮菏
台	㣍㰧㾂佁兘冶刣台咍囼坮始(㗠𠝔)孡怠(䈚緿)怡抬枱枲(㷘䈢䢄葈𣕘𦂅)殆治(箈菭𠶠)炱(㬃)炲珆瓵眙笞紿绐耛胎苔(𠫅𠫆𢰥𣹓𤠂𥀌𧀟𨃐𩌂)詒诒貽贻跆軩辝迨邰鈶颱飴饴駘骀鮐鲐齝𠄩𠊝𠳙𩲥
史	㕜㳏史鉂駛驶𣐳𪀎
右	㤑㳓佑(㐛)右祐醢𣖻𧙗
号	㞻䪽号呺枵飸鴞鸮𩖸
號	㙱號饕𡀱𣜵
司	㚸㟃䏤䛐伺司呞嗣孠柌泀祠笥覗詞词鉰飼饲
各	㓢㗉㤩㦴㪾䀩䅂䎊䞦䧄䶅佫各咯垎峈峉(𠸉)恪(𠸧)挌敋格(䈷𠺝𨃶)洜烙狢珞硌笿絡络胳臵茖(𠺴)蛒衉袼觡詻貉賂赂輅(簵)辂酪鉻铬閣(擱櫊𡁤𨆿)阁(搁)雒頟餎饹駱骆骼鮥鴼鵅
客	㟯䘔喀客愘愙揢楁碦額(𡅅𣌔𥗳)额髂
路	㯝潞璐簬蕗路鏴露(虂𤅟)鷺鹭𡀔𢷅𤮗𦓉𧒌𧒍𪛅
洛	洛𠸪
落	落𡀩𢣅𣋛𥋷𨮎
略	㑼㨼䌎略𨎟
畧	撂畧𠓀𠠩𥳂𨎠
吅	吅
合	㓣㕉㝓㢵㪉㭘㾑㿯䀫䆟䏩䞩䢔䨐䶀䶎佮冾匌匼合哈垥姶峆峇帢恰拾(湁)搿敆欱洽(㬁)烚珨畣(墖)盒硆祫秴給(𠎨𢵰)给翖耠蛤袷詥跲郃鉿铪閤鞈韐頜颌餄饸鮯鴿鸽龕龛𢈈𩭆𪘁𬌗
吉	㓤㔛㣟䂒䓀䦖䭇佶劼吉咭喆嚞夡姞恄拮桔欯洁狤硈秸結(鐑𢢂)结翓聐蛣袺詰(𠟸)诘趌迼郆銡鞊頡(擷纈襭)颉(撷缬)髻鮚鲒鴶鷧黠(䕸)𠮷𡋥𡳛𣻅𦛋𨀙
壹	㙪㦉㱅䊦亄噎壹嬄懿撎曀殪潱豷饐𠃸𡄻
同	㓊㖯㖰㢥㣚㸗䆚䞒侗同哃垌姛峒峝恫戙挏晍桐洞(霘)烔狪痌眮硐秱筒粡絧胴茼衕詷迵酮銅铜餇駧鮦鲖𦨴𪔚𫍣
名	㗮㫥䊅佲名姳洺眳茗詺酩銘铭𠱷𩳊
后	㖃㤧㧨㸸㻈䞧劶后垕垢(𢞄)姤洉缿茩詬诟逅郈銗骺鮜鲘𥅠𪁆
吏	㕝㤦㹬使(𣔤𣷱𦲺𧍅𧍇𩸲)叓吏𣥱𣦰𣳪𥒅𥟹𦧜𦪨𧀞𧳅𪘌
向	䖮向响垧姠恦扄晌晑珦銄餉饷𠽘
君	㟒䇹䞫侰君宭峮帬(𤸷)捃桾涒焄(蔒)珺窘(㩈僒)羣(㿏𡑳)群(𡀳𡑱𨆤𨮉)莙裙裠覠輑郡(㴫𠹴𤹓𦄄)頵鮶鲪鵘麏(𢹲)𡝗𢃆𤉙𫖳𬂁
吝	吝悋麐𠓬𠞺𠡧𠳺(𠼿)𡘯𡫫𢙵𢭹𣁔𣵰𤞼𤶾𧋻𨁮𨦽𪊺
[⿱乂厷]	㖁恡𪊭
吠	吠鼣𦜀
否	㤳㧵㳪䓏䫊䫠俖否嚭娝桮痞脴踎𠳝𣇊𥺖𨧆𩛷
含	㓧㟏㟔㤷㼨䎏䣻含唅娢晗梒浛焓琀筨莟蛿誝谽鋡頷颔馠𡌢𡪁𤚥𤞻(𣘉)𥆡𥓂𦛜𧳘
[吳]	㻍洖祦筽脵茣虞(噳澞鸆)蜈誤鋘麌𣮇
吳	俁吳娯悞
吴	俣吴娱悮误
呉	呉娛
吹	吹焁𠀿𢭻𣒱𣵯𣵶𤉚𤶺𥪅𥺏𥺔𧷝𨁰𩭜
炊	䶴炊
吾	㐚㹳䎸䏸䓊䦜㾔䮏俉吾唔啎圄娪寤峿悟(𦷮)捂敔(䢩)晤梧浯焐牾珸痦窹衙語(𠑕𡂂𢣸𤻭)语逜郚鋙铻鯃鼯齬龉𥟊𦀡𪘚
[吕]	㛎捛梠焒稆筥絽莒郘鋁閭(䕡䥨櫚)𢙲𣳮
吕	侣吕铝闾(榈)
呂	侶呂𠒦𠭤𠴊𡄀𡋿𡳎𣨕𤀗𤞪𤳧𥆻𥓅𥖓𥖕𥺓𨓐𨹬𪁳
呈	䄇䇸侱(𥰈)呈埕徎悜挰桯浧(塣)珵睈程脭裎逞郢酲鋥锃鞓𠴔𥺆𦀚𧋸𨁎𪓪
告	㬶䎋䚛䧊䧼䶜俈勂吿告哠喾嚳峼悎捁晧(㵆)梏浩焅牿皓(澔)硞祰窖(滘𨅻𪆥)筶聕艁誥诰郜酷鋯锆靠(㸆)頶鯌鵠鹄𠜯𡌃𣂋𤞺𤭚𥞴𥺊𦀽
周	㓮㚋㟘㨄䎻䓟䞴䧓䯾倜凋周啁奝婤彫(𧐸)徟惆晭椆淍琱皗睭碉禂稠綢绸翢蜩裯調(𢸛𧞴)调賙赒輖週郮錭雕(𧔿)霌騆鯛鲷鵰𨂊
咅	㕻㖣㟝㥉㰴㾦䋨䍌䎧䏽䞳䦣䬏䯽䳝䴺倍(蓓𡏧𡻓𣻃𦟋)剖勏咅培(𢊫𣼯𦟷𦹷)婄掊敨棓殕毰涪焙犃琣瓿碚稖箁菩賠赔踣部(篰蔀𧐾)醅錇锫陪(㯁䔒)鞛餢𣾾
咎	㰶㹾䓘䛮倃咎晷(厬)櫜綹绺鯦麔鼛𠴰
咠	㣬䁒䐕偮咠戢(嶯擑檝濈艥蕺霵)揖(䉗䔱)楫(𡀞)湒箿緝缉葺諿輯辑鍓𡎎𩹫
咢	㓵㗁㟧㬽㮙偔卾咢堮崿愕湂腭萼(𠿸)覨諤谔遌鄂鍔锷顎颚鰐鳄鶚鹗齶𥈭𥔲
㖾	㖾㦍䣞遻
[舌]	㓉䀨䄆䏦䒷䟯䣶䦚䯏佸刮(𠟥𠵯𢯔𣈛)咶姡懖括(葀𠸓)活(萿闊(𤄃)阔)秳筈聒舙蛞話话趏頢颳髺鴰鸹𠻉𦧘
[⿱氏口]	䯺桰銽
适	适
敌	敌
咸	㛾㨔㰹㺂䁍䖗䶠䶢减咸喊堿嵅椷減煘瑊碱箴(𢤝)緘(䌠𥶳𧁺)缄羬葴(䥠)諴輱醎鍼顑鰔鱵鹹麙黬𠁝𫍯
咼	㢐䈑䫚䯞剮咼喎堝媧旤楇歄渦煱(𡁜)猧瘑碢禍窩緺腡萵蝸諣踻鍋騧𢝸𢰸
呙	㖞㶽䯄剐呙埚娲涡祸窝(𫲄)脶莴蜗锅
過	㗻䆼䙤撾檛濄簻膼薖過鐹𢣄𩟂𪇍
过	㳡挝过𪁶
哀	㗒偯哀鎄锿𤠆
品	偘品榀煰闆
𢦏	㘽㦲䛋䣬䵧栽(溨)烖胾臷蛓裁載(儎)载(傤)酨𢦏
哉	哉渽睵賳𠼷𥯒𦞁𧛷𩹯
員	㜏䁚䆬䐣䚋䠝䫟傊勛(𤏩)員圓塤愪損(𨆥)殞溳熉磒篔縜蒷鄖隕霣韻鶰𠅳𡻖𣗼𧜘
员	㛣勋员圆埙损殒涢筼郧陨
貟	圎貟
贠	贠
哥	㢦䔅哥戨歌滒謌鎶鿔𠹭𣘁𤠄𪃴
哭	哭
唐	㜍㲥㼺䅯䌅䧜傏唐塘(䕋)嵣搪榶溏煻瑭瞊磄禟篖糖膅蓎螗赯鄌醣鎕餹鶶
商	商墒滳熵蔏螪謪
啇	㒀㠃㹍䁤䊞䎮䐱䙗䮰䵂啇嘀墑嫡摘(𪇪)敵樀歒滴甋蔐謫谪豴蹢適(㰅擿瓋藡讁𡂓𨮹)鏑镝
啻	啻膪
[⿰户攵]	䁈䏿啓(㬖𢴖)啟(闙𥳃)晵棨(𣘼)綮
启	启
啚	啚鄙
善	㵛㷽䦅僐善墡嫸敾橏磰繕缮膳蟮譱鄯鐥饍鱔鳝𠟤𠾺𢢆𧬆
喜	㝆㵙䵱僖喜嘻囍嬉憘憙敼暿橲歖熹熺瞦禧糦繥蟢譆饎鱚𨭎𬭳𬶮
喪	䘮喪
丧	丧
喬	㝯㠐㢗䀉䎗䚩僑勪喬嘺墧嬌屩嶠憍撟敽敿槗橋毊燆獢矯礄穚簥繑蕎蟜譑趫蹻轎鐈鞽驕鱎鷮𢄹𣾷𥼱𧄳
乔	㤭㳢乔侨娇峤挢桥矫硚荞轿鞒骄
單	㠆㲷㺗䐷䠤䡲䯬䵐僤匰單嘽嚲囅墠奲嬋幝(𡃐)彈(𤻾)憚戰(𡃹𡓥𢥇𥗜𧂁𧟀)撣暺樿殫潬燀癉磾禪簞繟蕇蟬襌觶譂貚軃鄲(䕤)闡(灛𢺛𥸍)驒鱓鷤鼉鼍𨭐
单	䃅亸冁单啴婵弹(𠽂𢠤)惮(𠼺)掸椫殚瘅禅箪蝉褝觯郸阐𧝧𫢸𫮃𬊤
単	単弾戦
喿	㿋䆆䵲僺劋喿噪嬠幧懆操(𧂈)橾氉澡(藻(㩰))燥璪矂繰缲臊襙譟趮躁鄵鐰髞鱢𣋝𤢖𥖨
嗇	㱇䉢嗇廧懎濇瀒穡繬薔轖
啬	啬穑
𦰩	㔮䎯䕿傼嘆囏嫨暵歎(擹)漢(𡁚)熯𢠦𤳉𦰩𧄊𨫪
[又1]	叹汉
器	噐器
噩	䫷噩櫮蘁讍鑩鱷
嚴	㘙䉷䕾䶫儼嚴壧孍巖(𡆑𥍛)巗曮欕玁礹讝釅麣
严	严俨酽
厳	厳巌𠑊
岩	㛧啱岩𣷰𤊤𤷳𥇷𩜠𩸶
囂	㺧䖀囂虈
嚣	嚣
囗	囗𨑕
囚	囚泅苬鮂𣭃
四	伵呬四怬柶泗牭訵駟驷
回	㻁䛛䤧佪回廻徊恛洄痐硘絗茴蛔迴鮰𤞑
囬	囬廽蜖逥
囘	囘𢌞
囟	㭡䛜䪿囟𡜧
細	細𦹀
细	细
因	㘻㧢㸶䂩䄄䍰咽因姻栶欭氤洇烟珚秵筃絪胭茵裀銦铟鞇駰骃𠗃𠡛𢙫𤶑𬘡
囙	㤙囙𤇆
[囪]	窗
囪	㘟囪
囱	囱
匆	匆匇
困	困悃捆梱涃睏硱稇綑裍閫阃齫𤞧𩒱
囷	㖥㻒䐃䠅囷棞碅稛箘菌蜠
麕	攟麕
麇	攈麇
固	䍛䓢䭅個(嗰)凅固堌婟崓崮棝涸痼祻稒箇錮锢鯝鲴𠴱𣎏𧶮
圂	㥵㨡㮯㯻圂慁溷𦞢
國	嘓國幗慖摑槶漍爴簂膕蔮蟈𤎍𥊞𧰒𨫵𪅦
国	啯囯国帼掴椢腘蝈𬇹
圖	圖圗𪛇
图	图
図	図
土	㐋䲧吐土圡徒(𠻀𢟎𢲛𣘊𣺺𤸭𥱰𦪂)扗杜(荰𠴗𥮊𧹥𨁥𨧀𬭊)社(䀅)肚芏釷钍靯𡉿𢭰𤣰𤬪𩵚
圣	㹩圣柽蛏
[圣]	䇈怪(𠶔𢯑)恠柽𠱅𢫞𣲾
圥	圥
在	在扗茬
圭	㙓㤬㪈㰪㾏䅅䖯䙵䞨䯓䳏䵷佳(龿)刲劸卦(啩掛(𦟺)罫褂𩳴)哇圭奊(䜁)奎(㛻㥣㨒䠑喹楏煃睳蝰鍷)娃(㥨)徍恚(㜇𠹤)挂晆桂(溎蓕𠺺𥉯)洼(䨟窪)烓珪畦眭砉(剨湱騞𬴃)硅窐窺筀絓罣(𢠪)胿茥蛙街袿觟詿诖跬(𠏠)邽銈閨闺鞋(嚡)鮭鲑黊(蘳)鼃𫓯
厓	厓啀堐娾崕崖(嘊漄)捱涯(𠽎𦹹)睚𠊎𣔦𧍊
圼	㖏㘿圼捏涅(篞𡮛𢟗𣻾𦄇)陧𣵀𦁻
[⿱白工]	𠵋𠽇𡐘𡥴
[⿱臼工]	揑湼隉𢝘
坐	㘴㛗㟇㭫䂳䟶䦟侳剉唑坐夎(蓌)座(蓙𨫈)挫痤睉矬脞莝(遳)趖銼锉髽
坒	㙄䏶䯗坒悂梐狴蜌陛(𠹯)
坤	坤
坴	㓐㛬䡜勎坴淕睦稑踛逵錴陸鯥鵱𩣱
陆	陆
垂	㩾㻔䅜䍋䮔䳠倕厜唾垂埀埵娷崜捶棰涶甀睡硾箠綞缍腄菙諈錘锤陲
垔	㖶㢾㮒㷑䃌䓰䗎䚈凐垔堙歅湮煙甄(籈薽)禋緸諲鄄闉陻黫𬤇𬮱
𠂤	㢂䏨垖桘頧鴭𠂤
垚	垚
埶	㙯勢埶摰暬槷槸熱(爇𢤢)蓺(囈藝襼讛𠑢)褹褻𦄌
[执1]	亵势热
執	㝪䉅䙝䠟䥍䲀執墊慹摯漐瓡縶蓻蟄褺謺贄騺鷙𠽃𡼈𢴇𣊎𣎖𣼳𤎒𥊝𨄴𩮿
[执2]	垫执挚絷蛰贽鸷
堂	㑽㙶䣘嘡坣堂憆摚樘漟瞠糛膛螳蹚鏜镗闛隚鞺饄鼞𡠠𤎌
堇	㝻㨷㹏䈽䌍僅勤(㢙懃懄𡀣𣝀𥵚)囏堇墐嫤廑慬斳槿歏殣漌瑾瘽菫蓳螼覲觐謹(𡄾𢥢𤄲)谨鄞饉馑騹
仅	仅
堯	㚁䁱䰫䴃䶧僥嘵堯墝嬈嶢憢撓曉(䥵)橈澆(𤄮)燒獟皢磽穘繞(𡅍𥽵𦇇)翹(𧄍)膮蕘蟯襓譊趬蹺(𨇵)遶鐃顤饒(𠑬𡆁𥍘𦈂𦣗𩰈𩽸)驍髐𠨪𡗉𡗊𢿣𣩦𥪯𧹅
尧	侥哓娆尧峣挠晓桡浇烧硗绕翘荛蛲跷铙饶
尭	尭暁焼𣓤𩜙
報	報蕔𠾷𢵨𤺴
报	报
[⿳宀⿻龷一八]	㥶塞(㩙僿噻簺𡑮𤀕)寨(㩟𩠵)賽(㘔)赛(㗷)
塵	塵薼
尘	尘
士	㐊仕士壭𢩿𤴶𥾘𪐢
仕	仕茌(𣖝)𠱊𢫟𣐴𤇧𤵴𥿥𨀋𨦁𪀆𪐾
壬	䏕壬妊紝纴衽飪饪
壯	䊋匨(㮜)壯壵奘娤梉焋莊(糚)裝銺𠨡𤶜𤽸𨡈𩈪
壮	壮荘装
庄	㽵庄桩粧脏賍賘赃𥅾𦀐
壴	㛸㰻䐍壴
壺	㯛壺
壷	壷
壶	壶
壼	壸壼
壽	㦞㹗㿒䊭䌧䬞䮻䲖儔嚋壔壽夀嬦嶹幬懤擣檮濤燽燾璹瓙疇禱籌翿薵譸躊軇醻鑄隯魗
寿	㤽䓓俦寿帱梼涛焘畴祷筹(𡀤)诪踌鋳铸陦𢭏𫜷
夂	夂
夃	夃羖股
夅	䂫䇨䜶佭夅栙洚絳绛袶跭逄鿍𠲓
降	䧏降𤌅𩄐
[⿰章夅]	䤗竷
夆	㛔㶻㸼䀱䏺䴶埄夆峯(㷨樥溄鎽)峰捀桻浲烽琒綘胮舽艂莑蜂鋒锋韸髼𧧽
夊	䒘夊
夋	㕙㛖㻐䘒䝜䞭俊(䈗葰)唆埈夋峻悛捘晙朘梭浚焌狻畯痠皴睃稄竣羧脧荾誜賐踆逡酸鋑陖(𡍵)餕馂駿骏鮻鵔鵕黢𢓭𨌘𪊴
[⿳囟八夊]	傻(𠿬)儍
夌	㖫㥄㱥䈊䗀䬋䮚倰凌(蓤鿛)堎夌婈崚庱掕棱(𡼹)淩(蔆)睖碐祾稜(薐)綾绫菱裬踜輘錂陵(䉄䔖𠻱𢁋)鯪鲮𠦻𤊥𦝄(𣎞)𦡟𧤁𧤂𨉞𩜁𪘵
复	㙏㚆㬼䧗䪖䮡复復(㠅澓癁蕧覆(𢺁))愎椱稪緮腹蝮複輹鍑馥鰒鳆𩜲
夏	厦(𡐯)嗄夏夓廈榎𡏘𡟺𤧶𦷜
夐	夐敻瓊(𤓇)矎藑觼讂𢷳
夒	㹛夒巎獿
擾	擾𡅒
夔	䕫夔巙犪蘷虁躨𧅄
夕	㶤夕汐矽穸釸
夗	㠾㼝㽜䖤䛄䳃夗妴怨(葾)盌眢苑駌鴛鸳𢪸
夙	㑉夙洬珟
多	㗬㞔㡅㢁㶴䏧䡔䫂䬷䮈侈(㢋𠝓𣔢)卶哆垑多夛奓(䃎䋾䐒䵙偧)姼恀扅拸栘爹(嗲)痑眵茤蛥袲(㒅橠)袳誃趍(㿐)跢迻鉹陊黟𠀲𠫾𡗅𡗋𡥥𣃽𣴙𤿦𥒥𥶂𪐀
移	䔟熪移簃謻𠼪𢴐𣻗𧐹𨄼𨖨𪅨
夜	㖡㖱䘸䤳亱夜掖棭液(𦟸)焲腋鵺𤥿𥯊𦁹𦲹
大	㐲㞭䲦大忕戻(涙)杕汏軑轪釱馱驮𣧂
达	㳠哒垯挞荙跶达闼鞑鿎𫟼
太	㑀冭呔太夳忲态汰粏肽舦軚迏酞鈦钛駄𡛕𡳁𢪯𧘹
泰	㤗㥭傣泰溙𣳾𫂐
仄	㳁仄庂昃(𦝈)汄
天	䀖䗞䘉䚶兲天沗祆蚕
吞	㖔㧷㶺吞𧌀
夫	㝬㠸㫙䃿䄮䊿䡍伕呋夫妋巭扶(荴)枎玞畉砆肤芙蚨衭趺邞酜鈇颫鳺麩麸𫓧
夬	㭈㹟䀗䆕䊽䏐䦑䦼䫼决刔吷块夬妜快(筷𢭴𧋿)抉(䆢)決(𢭯)炔玦疦砄缺(蒛)芵蚗袂觖訣(𥊜)诀赽趹鈌駃鴂鴃𦑗𫘝
夭	㕭㤇䴠仸夭妖宎岆岙扷枖殀沃(鋈𠴎)祅秗穾芺(䄏)袄訞跃镺飫饫鴁
央	㹧㼜㿮䄃䇦䒋䬬䱀佒咉坱央姎岟怏抰映柍殃泱炴眏秧紻胦詇軮鉠雵鞅駚鴦鸯𦁾𧲱
盎	盎醠𣺻𤮃(𡂍)𧏱
昊	昊淏
失	㲳䭿䰡䱃䳀佚劮呹失妷帙怢抶昳柣泆瓞眣祑秩(𠅼𠞠)紩翐胅苵蛈袟袠詄趃跌軼轶迭(𦂾𨕀)鉄铁镻鴩
夷	㯩㹫䄺䧅䨑䩟䮊侇咦夷姨峓恞挗桋洟痍眱羠胰荑(𠺹)蛦跠銕鮧鴺𢓡𣆰𣭯𦀊𧣧𨱾
夸	㡁㰭䠸侉刳咵垮夸姱恗挎晇桍洿瓠(摦槬)絝綔绔胯舿荂袴誇(𡀵)跨郀銙陓骻鮬鴮
夾	㛍㤲(㥷)㰰㼪㽠㾜(㿓瘞瘱)䀹䛟(䕛)䧪䩡䬊䵌䶝俠匧(㥦㰼愜篋陿)唊埉夾峽悏挾梜殎浹(𢲯)狹硖硤筴(擌)綊翜(㵤)聗脥莢蛺裌郟鋏陜頰鵊𥞵
夹	䇲侠(㮉)夹峡挟浃狭瘗荚蛱郏铗頬颊𨦇𬂩
[⿷匚夹]	惬箧
奄	㛪㞄㡋㤿㪑㭺㷈㽢䁆䄋䅖䎨䛳䣍䤶俺剦匎唵埯奄崦庵(蓭𠻒)掩晻殗淹痷硽罨腌菴裺醃閹阉餣馣鵪鹌黤𩸆
奇	㚡㞆㟢㢊㥓㨳㱦㾨㿲䄎䐀䓫䗁䛴䩭(羇)䫑(䫯)䭲倚(𦟑𧱺)剞埼奇婍寄(槣𥊘𦗞𨄾)崎徛掎攲敧旑旖(檹)椅欹渏犄猗(漪)琦畸碕綺绮裿觭踦躸輢錡锜陭騎(𫬷)骑鵸齮𠵇𤯱𥺿𬺈
竒	嵜竒﨑𢰤𤦺𥔎
奉	㷯䏾䩬䭰䳞俸(𠺭𣻈𩄴𩺨)唪埲奉捧棒(𠾴)淎琫菶蜯𡞗𢜗𣈖𤊡𤷰𧯵𩃳𩗴𩸮(𢺒)
奏	凑奏揍楱湊腠輳辏𠸫𡔿𤋷𥠬𥯪𧎝
奐	㪱㬇喚奐寏愌換渙烉煥瑍瘓
奂	㛟唤奂换涣焕痪
奔	倴喯奔捹渀逩錛锛餴鼖𥮈𧶭𨁼𩣺
奚	㜎㨙㰿䙎䫣䳶傒嗘奚嵠徯慀榽溪(㶉鸂𤐓)磎縘膎蒵螇謑谿豀豯貕蹊雞鞵騱鳮鷄鼷𡏛𥉐𥻺𫘬
鸡	鸡
奠	㞟㽀䥖奠橂磸𢵫
鄭	擲躑鄭𢤜
郑	掷踯郑
[奧]	㜩㠗䉛䐿䜒䴈噢墺嶴懊擙澳燠礇薁襖鐭隩鿫𩼈
奧	奧
奥	奥
奪	奪𡁯
夺	夺
奮	奮
奋	奋
女	㚢㣽女汝(㖳𠲤𢬨𨀾)籹肗邚釹钕𠯆𡛤𡝖𡢻𥫭𦬑(𠴑)𧴱𩚔
奴	㐐䋈伮努(𢭵)呶奴孥帑弩(𢮫)怒(𦵚)怓拏(𠸎𣸏𤸻)砮笯胬詉駑驽鴑𩛂
拿	㧱嗱拿鎿镎𠌧𢲡
好	䒵好恏薅(𧂭)𠲡
如	㖲㾒䘫侞如帤恕挐(蒘)桇洳筎絮(㵖蕠)茹(𣺾)袽銣铷鴽𤈟𥆃𦀌
妟	䳛妟宴(𠻈)
妥	㞂㟎㱣㼏䅑䧌俀哸妥娞挼(𥱮𩝺)桵浽綏(䕑)绥脮荽鋖鞖餒(𤃠𥷓𩟼)馁骽鮾鵎𢚶𧞥𨁡
妻	㼮䃀凄啛妻悽捿棲淒緀萋褄郪霋鶈𩸸
妾	䈉唼妾帹接椄淁翣菨踥霎鯜𢜡𤗈𨨧
委	㢻㣦(㞜)㮃㹻䅗䆧䍴䫋䬐䰀䴧倭唩委婑崣捼涹痿矮緌腇萎(𠾭)蜲覣諉诿踒躷逶錗餧
魏	䭳巍犩蘶魏𨇷
[老]	姥峔
姦	姦葌
威	㙎喴威媙崴揻楲縅葳蝛隇鰄𦞏
婁	㜢㪹㺏㻲䅹䝏䣚䫫䱾僂嘍塿婁屢(𡀿𤮒𦧃𧀓)屨嶁廔慺摟樓氀漊熡甊瘻瞜窶簍縷(𧃒)耬膢艛蔞(𣞾)螻褸謱貗軁遱鏤鞻髏鷜𤬏𩯁
娄	㥪䁖偻喽娄屡(𠎪)屦嵝搂楼溇瘘窭篓缕耧蒌(𦡢)蝼褛镂髅𡞱𡢐𥹰𦝼𨍦
數	擻數櫢籔藪𡂡𨯃𩖅𩪵𩽋
数	䉤擞数薮𥐈𥨧
婦	婦
妇	妇
嬰	䑍䙬䨉嚶嬰孆孾巊廮攖櫻瀴瓔癭纓蘡蠳鸚𨰃𪝼
婴	嘤婴撄樱璎瘿缨鹦
[⿱𭕄女]	䋝桜珱
[⿱吂䏎1]	嬴(㜲䃷䑉䕦攍瀛籝)贏(灜籯)赢
子	㜽㞨㺭䦻䰵仔吇子孖孜(㤵)杍矷秄籽耔芓虸釨𡥄𤜭
孑	孑
孓	孒孓
孔	吼孔
孕	㚺䱆孕𠱆𥩯𨀊
字	字牸茡
存	侟存拵栫洊珔臶荐(鞯)袸銌𠱜𢙨𣆱𤞐𤶐𦛊𧋃𨒸𨚲
孚	㟊㲗䞯䨗䱐䳕䴸俘哹垺娐孚孵捊桴殍浮烰琈稃筟粰綒罦脬艀莩(𠼼𦟵)蜉郛酻馟
孛	㛘㟑㪍(㴾)㫲㶿㹀䪬侼勃(愂渤葧𦂿)哱孛悖挬桲浡綍脖荸(𠍤)誖郣鋍餑饽馞鵓鹁𡋯𤶽𥹸𨁝𩓐𰬘
孝	㭳㹲䓔侾哮孝宯庨涍痚硣窙誟踍酵𤉗𤽴𫰪
孟	䁅䓝勐孟掹猛艋蜢錳锰鯭𠵼𢛴𤗖𤷪
季	㑧㳵㻑季悸痵鯚𡳜𢯗
孨	孨
孫	孫愻搎槂猻蓀遜(䕖)𣻆
孙	孙狲荪逊
孰	䃞塾孰熟
孱	㻵僝孱樼潺轏驏骣𢢁𢵔𦠳
孴	㵫孴
𦥯	㽇䁷䑁䮸嚳壆學(㙾㩭㰒㶅斅斆)嶨澩燢礐覺(攪灚𧅫)觷雤鱟鷽𠿟𦥯
[⿱𭕄冖]	喾学(敩)峃泶覚(撹)觉(搅)鲎鸴𬒈
宀	宀
宁	䍆䘢伫佇宁柠眝竚紵纻羜苎苧詝貯贮
它	㸰㼠㾃䍫䙾䡐䪑䬁䴱佗咜坨它岮拕柁沱砣紽舵(鿳鿸)蛇(㵃)袉詑跎迱酡鉈铊陀(𦱆)駝驼鮀鴕鸵鼧𧹟𬶍
守	䢘垨守狩酧𢬇𣑋
安	㫨䀂䅁䢿䯃侒咹垵姲安峖按案桉氨洝胺荌銨铵鞌鞍頞鮟鴳𩣑𩽾
宋	㧲䊉䫅俕宋
完	䯘䴷俒唍垸完捖晥梡浣烷琓皖睆筦綄羦脘莞輐鋎院鯇鲩鵍𧨎𬘫
宓	䀄(㵥)䁇宓淧
蜜	櫁藌蜜𦢉
宕	䦒宕菪趤雼
宗	䑸䝋倧婃孮宗崈徖悰棕(䉘)淙猔琮碂粽綜综腙萗誴賨賩踪錝騌骔鬃鯮𥟡
官	䗆䘾䠉䦡䩪倌婠官悹(䪀)悺捾棺涫琯痯管(䌣䲘鳤)綰绾舘菅輨逭錧館馆𠴨𣨭𩭵𩸘
定	㝎䘺䧑啶埞婝定掟椗淀琔碇綻绽聢腚萣蝊諚錠锭靛顁𠉵𦩘
宛	㱧䑱䗕䘼䛷䝹䡝䩊䩩䯛䵫倇剜啘埦婉宛帵惋惌捥晼椀涴焥琬畹睕碗箢綩腕菀蜿豌踠鋺鵷鹓黦𡮄𢏿𥺹
宜	㝖冝宐宜椬竩萓誼谊𠊙𠵌𡹠𢯕𣦍𣶺𦖑(𠐅)𩓧𪘲
宣	䙋䳦喧塇媗宣愃揎暄楦渲煊瑄睻碹箮縇翧萱蝖諠鍹鰚𤸧
室	㗌室榁腟鰘𩋡
宦	䆠宦
[宫]	㴦䃔熍
宫	宫
宮	宮
宰	㱰䏁䔂䮨宰梓滓縡𠹼𢟓𢲟𥻮
害	㪡㮫㲅割(𢵷𥢫)嗐害搳犗瞎磍縖螛豁轄辖鎋鶷
家	傢嫁家幏榢稼鎵镓𠺢𣺊
宷	宷
審	㔤㰂嬸審瀋覾讅𡂹𣠒𧺀𧺁
审	婶审
宩	㛽宩
容	㮤㼸䈶䡥傛塎嫆容嵱彮愹搈榕溶熔瑢穃蓉(㯴)褣鎔镕鰫𩘨𩘪𪃾
宿	㜚㝛㴼䈹䑿宿摍樎縮(𧃴)缩蓿蹜鏥
寅	㝙㪦夤(濥)寅戭殥演璌瞚縯蔩螾鏔𠻤𡫫𢴍𣘹𥳄𦟘𨄻𬙂
密	㑻㨸䈼䌏嘧宻密樒滵蔤鿹𦟽
寇	㓂䓻䳹冦宼寇滱窛簆蔲蔻
寍	寍
寒	㒏㩃寒𢢈
[⿳宀⿻龷一八2]	㥶䗙䞿寋弿搴(藆)褰(攐)謇蹇(䙭䮿攓瀽鑳)騫(㩷)骞鶱𬸣
寡	寡
寣	寣
實	㺙實
实	实
実	実
寧	㣷㲰䗿䭢儜嚀嬣寕寧懧擰檸濘獰矃聹薴鑏鬡鸋𡨴𤘓𤾱𦅜𦆭𦡲𧭈𧰗𩕳
[宁]	䘢咛坾宁拧柠泞狞眝聍苧𨀉
甯	䔭寗橣澝甯𤀑
寸	刌吋寸忖村(𠴘𢚳𦀹𦛻)衬𢩭
寺	㫭㭙䓁䝰䦙侍(㣥)寺峙庤恃歭洔畤痔(𣙦)秲詩(𡮲)诗跱邿鼭𪀔
待	偫崻待𠸤𢱜𣹘𤋵𦃀𦞒𧛶𨃉
持	持𣖖𥻣𨃌𨨲𩹭
寽	㭩㲕㸹㽟䟹䮑哷埒寽捋浖脟蛶酹鋝锊頱
封	㜂㨍䋽堼封崶幇幫湗犎篈葑鞤
尃	㗘㙛㬍䍸䎔䗚䙏䪙䰊䶈傅博(簙𣽡)圑尃愽搏榑溥(簿薄(䭦欂礴))煿牔猼禣糐縛(嚩)缚膊蒪(䥬䪇礡鑮)賻赙鎛镈餺馎髆𨍭
旉	旉
敷	㩤懯敷璷
射	㓔㴬塮射榭謝谢麝
將	㢡㯍䉃䊢䒂䵁䵼墏奬將嶈摪槳漿獎蔣螿蹡醬鏘鱂𡁷
将	奨将蒋螀醤锵鳉𨪙
[⿰丬夕]	奖桨浆酱
專	䁣䊜䧠傳(𡀯𧓆)剸團(㩛檲糰)塼嫥専專慱摶暷槫漙瑼甎磚竱篿縳膞蓴轉(囀)鄟鏄鱄鷒
专	䌸䏝专传抟砖转(啭)
团	团
尉	㷉䲁叞墛尉嶎慰(藯)熨犚罻蔚螱褽霨鳚𣻷
尊	䔿僔噂墫壿尊嶟撙樽澊燇竴繜罇譐蹲遵鐏鱒鳟鷷𣞊𨱔
尋	㜦㝷䫮噚尋憳撏攳樳潯燖璕蕁蟳襑鄩鱘𢿼𦅛
寻	㖊寻挦桪浔荨鲟𫊻𬊈𬍤𬩽
尌	尌樹澍闘鬪
廚	幮廚櫥躕
㕑	櫉𨆼
厨	㡡厨橱蟵蹰𧒉
树	树
對	㠚㦠㬣䨴嚉對懟濧薱襨譵轛鑆𢷮𣌒𣝉𤻫𦆹𨆷𨘗𩟡𩼷𩼸
对	㳔对怼
対	対𠲝𢇉𢙪𢬭𣋇𧻐𨒻𩛜
小	㕾㭂䒕仦小毜釥𠃝𥾗
少	㠺䏚䒚䖢䟞䯯仯吵妙(𠴕𢭼𨁭)少抄(莏𠳕)杪炒玅眇(渺篎緲缈𥻠𦳥𪃧)秒粆紗(䔋)纱耖觘訬鈔钞麨𡂌𣲦𨈘
尔	䟢你(您)妳尓尔弥(猕)沵狝玺祢迩鉨鿟鿭𢘝𥅘𨤰(𥜡)
尒	㚷䇣伱尒苶鉩
尖	尖𢬅𣑷𥭍
尗	㑐䦊尗敊茮鮛
尚	㫾㭻㲂䊑䟫䠀䣊倘(𣦛)埫尙尚徜惝淌瓽甞緔绱耥裳趟(𢸋)躺鋿鞝𠶤𣎃𣦎𥊢𥊣
嘗	嘗嚐鱨
尝	偿尝鲿
黨	㿩䣣儻戃攩曭欓灙爣矘讜钂黨
党	傥党谠鎲镋𣗋𣺼
掌	幥掌撑礃罉鐣𣛟𥋇𦪦𩇢
棠	㒉䉎棠橖鏿饓
常	㦂嫦常瑺蟐鏛𣙟
賞	償賞贘鑜
赏	赏
牚	撐橕牚𦉘𨅝
尞	㙩㞠䜍䝤䨅䩍䭜僚(𡒭)嘹嫽寮(屪曢藔𠐟𠠙𤖡)尞嶚(𨇉)嶛憭撩(𡃔)暸橑(䕩)潦燎爒獠璙療瞭竂簝繚缭膫蟟蹽轑遼(𤃜)鐐镣镽飉鷯鹩𦼔𧄈𩻻
尤	㕱㚭优尤忧扰沋犹(莸)疣紌肬蚘訧駀魷鱿𣏞𦬓
尨	㟌㤶䏵䵨厖哤娏(䓼)尨浝(㙙㴳)牻狵痝硥蛖駹
就	㠇㩆僦噈就憱殧蹴蹵鷲鹫
尸	㕧㞒䐅䲩尸屃屍屎屓屭杘迉鳲鸤
尹	䪳伊吚尹笋芛
尺	㘮䋇伬呎尺択沢蚇訳迟釈鈬駅𡵸𥐮
尼	㞾䘦䛏䝚䲿伲呢坭妮尼屔怩抳旎昵柅泥(埿)狔痆眤秜胒苨蚭跜迡(𠸽𣖗)鈮铌馜𠉞𢓚𥬩𥿡
尾	㞑䅏䇻䊊䜸䞔䬿娓尾屗捤梶(𣛢)浘艉荱𠉜(𠎴)𠳿𡲤𡲫𡳎𡳒𡳩𢽙𣍁𤽶𥒮𥖑𥜀𦀿𦅴𦘧𧋦𧚟𨁱𨘘𨤔𩷳
尿	㞙㳮尿脲
局	䎤䏱侷局挶梮焗跼鋦锔駶𤶹𥐏𩓛𩠧𪁵
居	䅕䋧䛯䝻䱟䵕倨剧啹婮居崌据椐涺琚腒艍蜛裾踞鋸(𢤹)锯鶋𡍄𩤅
屈	㭾㻕䓛䘿䞷䠇倔啒堀屈崛崫掘淈煀窟(㵠𦡆)誳镼鶌𡲬𤟎𥇣
屋	䌂䠎偓剭喔媉屋幄握楃渥箼腛齷龌𡳽𦢡𦢢𧎜𨵱𩠭
屑	㣯㨝㴮屑榍碿糏
展	㜊㞡䱼展搌榐碾蹍輾辗𣺹𥉲𦟌𨃨𨫀𩥇
屖	屖搱稺謘遟
屚	屚漏瘺
屠	䠧䣝屠廜潳鷵
履	履
屬	䌵䙱䠱劚囑孎屬斸曯欘灟爥矚蠾钃
属	㔉嘱属瞩
屮	屮
屯	㹠㼊䓐䣩伅吨囤(𥇈)坉宒屯庉忳扽旽旾杶沌炖瓲盹砘窀純(蒓𢲝)纯(莼)肫芚訰豘軘迍(𣔝𦝊)邨鈍(𡚃𢵶)钝霕頓(噸𦡋)顿飩饨魨鲀黗𡭻𡶁𤵊𥂉𥫱𦟒𧉙𧘸𧿬𩂄
屰	㡿(㴑蝷)屰𠱘
逆	磀縌逆𠸺𡏤𪄧
山	㢫䴮圸奾山屾旵氙汕灿疝秈籼舢訕讪赸軕辿邖𠮿𢇢𤜬𦘹𨥉
岑	㖗䤫䫈侺埁岑梣涔硶𪁏
岡	㟠剛堈岡崗掆棡焵犅碙綱罁鋼𣷣
冈	㧏㭎冈刚岗纲钢
罡	㓻㟵䌉堽罡鎠
岳	岳捳𥇸𩓥
崇	㓽崇崈漴𠼾𢠄𣙩𥊠𧐿𨅃
崔	㜠䜅催(𡀰𨮑)凗嗺墔崔嶉嶊慛摧槯(𢋬𣝤𥶮)漼熣獕璀皠磪繀膗鏙
崩	䙖䣙傰剻嘣塴崩漰磞繃蹦鏰镚
嵒	嵒癌
嵩	嵩𡀢𢣆
巂	㔒㽯䪎䭨儶孈巂攜欈瓗纗蠵觿讗酅鑴雟驨
嶲	㒞㩦㼇䥴嶲觽觿𢹂
携	㩗携
巜	巜
川	㸪䡅圳巛川巡廵杊汌玔紃訓(瞓)训釧钏順頻顺馴驯𬘓
州	㖄喌州栦洲絒詶酬銂駲𧋀𪣏
巠	䀴䞓䣆䪫俓剄勁(葝𤠃)坕坙娙巠弳徑挳桱殌氫涇烴牼痙硜經羥脛(𣻽)莖蛵誙踁輕(鑋𢷰𧸰𨆪)逕鋞陘頸鵛𠗊𠲮
[⿱ス工]	刭劲弪径氢泾烃痉硁经羟胫茎轻迳陉颈𣐕𫰛
[圣2]	経軽頚𦙾𫞬
巢	㑿㺐䜈䟁䲃剿勦巢摷樔漅(薻)璅窼繅缫罺轈鄛𠻥𥊌
巣	巣
巤	㯿㲱㼃䁽䃳䉭䜲䝓䪉儠巤擸爉犣獵(𧄵)臘(𢺎𥸆𧅕)蠟躐邋鑞镴鬣鱲𧀨(𢺍)𫚭
工	㓚㣉䉺䜫䞑䪦䫹䲨仜冮功(昮糼)卭(笻)叿妅屸工扛攻杠汞(㶹觨銾)灴玒瓨疘矼紅(葒𠸣𢞃𣖘)红(荭)缸羾肛舡虹(渱)訌讧豇邛(㧭桏筇)釭項(䁰澒𠾿)项魟𣒳𦏺𫚉
江	江茳鴻鸿𢏠𢬥𣑴𥆀𥬮𨀹
左	㝾䦈佐咗左袏𣳇
巨	䢹䣰䶙乬佢姖岠巨巪弡怇拒昛柜歫炬矩(榘)秬粔耟苣蚷螶衐詎讵距鉅钜駏鮔𠰠𡗐𢀥𢀦𢀬𢀭𢀮𢀲𣙬𥑭
洰	洰菃
巩	㧬㮪㺬㼦䂬䅃䊄䡗巩恐(𠺱)蛩跫銎鞏
巫	巫莁誣诬鵐鹀
差	㞉㷢㽨㿷䁟䐤䑘䟀䡨䰈䱹䴾傞嗟嫅嵯嵳差搓暛槎溠瑳瘥磋(䕢)縒艖蒫褨蹉醝鎈髊鮺鲝鹺鹾齹𡏦𡗂𦟎
己	㞯㽶䄫䪱圮妀妃屺(䒻)己忋杞玘紀纪芑記(䓽𣉸𥱬)记起(𠺬𤠳)邔魢鱾𣅗𥫟
忌	䋟忌梞誋跽鵋𠲹𡜱𣇡𧋷
改	改𠳚𢚲𢭮𣒵𦀻𦰦
巳	㰝㱼䇃圯巳异戺攺汜祀釲𡵆𣏌𦬊
巸	媐巸
熙	㜯熙𠘕𤏁
已	已𠖰𠯇𡉏𢩽𤣱𥐦
巴	㞎㿬䯲䶕吧夿妑岜巴帊弝把(筢𠴙𥖖𥺕𨁩)杷爬爸琶(潖)疤皅(葩(𡀥))笆粑紦耙舥芭(𢯓)蚆豝跁鈀钯靶鿱𠀧(𡝕)𠄧𠇕𠌊𢁍𢽼𣀟𤆵𥸿𧤭𧥔𩨜
卮	卮栀
巵	㛂㯄巵梔
巽	㔵㢲㦏㯢㷷䍻䠣僎噀巺巽撰潠簨繏蟤襈譔選鐉顨饌馔𡮭𡮸𢮪𦠆𦺈𧾌𩪞
巾	㧆䘜巾𢎭
巿	㤄㧊㸬㺻䍨䑔䟛䢌䣪䰽伂巿旆昁杮沛(霈𢭿)犻肺芾馷
帀	㺰䞙䴓帀沞迊銟韴魳鳾𠯗
匝	㧜匝咂砸鉔𠇽𣐝𦚗𦭧
市	姉市柿鈰铈
布	㘵㚴㳍佈咘布怖抪柨鈽钸鿻𢃊𣔩𤤰𥿠𨀒
希	㛓㟓㠻㹷㾙䖷䛥䤭䮎俙唏希悕晞桸欷浠烯狶琋瓻睎稀(𤏤𤏨)絺脪莃豨郗鯑鵗𣱬𩊽𫄨
帚	㫶㴆埽帚掃箒(𣞂)菷鯞
帝	㛳䫕䱱偙啼媂崹帝揥楴渧碲禘締缔腣蒂(𤀐)褅諦谛蹄遆鍗鶙𢋠𢝃𤧛𥰆
帥	帥
帅	帅
師	師溮獅瑡篩蒒螄鰤鶳𩮭
师	师浉狮筛蛳𫚕
席	席蓆褯𠻊𥱊
帶	㗣㦅㯂㿃䐭䠠僀墆嵽帶廗慸摕殢滯(懘)艜蔕螮蹛遰𠁑𡠹𢄩𢋴𤠹𦄂𧜵𧫚
带	㛿䗖䙊带滞𫶇
帯	帯鿮
[⿳世冖巾]	𣻉𦷾𩺌
干	㔓㢨㶥㸩㿻䍐䧲䵟仠刊(𠰙)厈奸姧(䓸)屽干忓扞攼旰(涆)杆汗犴玕皯盰矸秆竿罕(浫)肝(𨧠)芉虷衎衦訐讦豻赶軒(䆭搟蓒𠻃𢟑𤹖)轩迀邗酐釬閈闬靬頇顸飦馯骭鳱鼾𤴲𦏹𨸗𩂀
岸	㟁䮗堓婩岸硸錌𠵚𡶨
平	㛁㼞䍈䍬䶄伻匉呯坪(𦱾)平怦抨枰泙(萍)玶砰秤胓苹蚲評评軯閛駍鮃鲆𤇊𨥾
年	哖姩年脌鵇𡋂𢆘𢆡𢆭𢧚𢬧𣑻𦀅𦮴𨦧
开	㰢㿼䀘䄯䍾䙹䵤妍岍开枅汧研(䊙揅)笄(䗗)茾蚈訮豜趼邢鈃開(𥳐)雃鳽
幵	䶬咞姸幵栞詽豣麉𢏗
羿	羿
并	㔙㤣㻂(䔊)䈂䑫䦕䴵併垪姘帡并庰恲拼栟洴(蓱)瓶皏硑絣缾聠胼艵荓蛢誁賆跰軿迸郱鉼頩餅饼駢(𧟁)骈骿鮩鵧𥩵
屏	偋塀屏幈摒竮箳𠝭𣖕𣸹𤭸
幷	倂帲幷甁腁輧逬餠騈𧚭
屛	屛簈
幸	㓑㼬䁄䂔䛭倖啈婞幸悻涬緈𢔛
幺	䯚吆幺
幻	䒛幻𠯻
幼	㑃㓜㶭䬀䱂呦坳孧岰幼怮拗柪泑狕眑窈聈苭蚴袎詏軪靿鴢黝𥁒
幽	㗀䫜幽𢉾
幾	㙨㡬㼄䟇䤒僟嘰幾機璣畿磯禨穖耭蟣譏鐖鞿饑魕𧝞
广	㚧㢂广
庚	㗮㹹庚掶椩焿菮賡赓鶊鹒𢉼𥓷
度	䩲剫喥度渡艔踱鍍镀𨍏
庶	㫂㵂䉀䗪䩾䭖嗻墌嫬庶庻摭樜熫蔗蟅謶蹠遮鏣鷓鹧
这	这
康	㝩㱂䆲䗧嫝嵻康慷槺漮穅糠躿鏮鱇𡐓𩾌
庸	㟾㣑㺎䗤䧡傭嘃墉嫞庸慵槦滽牅牗鄘鏞镛鱅鳙鷛𦟛
廉	䆂䭠劆嬚廉濂燫簾(𢆁)臁薕蠊譧鐮镰𠿳𣜰𤻑𥋲𦧷𧞋
亷	䥥亷濓𡫐
㢘	㢘
帘	帘
廌	廌
廛	㙻廛瀍纏躔鄽𡃚𢷹𤒲𥌬𧁶𨮻
㕓	㕓壥纒𨇠
厘	䣑厘糎緾
㢆	㢆缠
廣	㼅䊯儣兤嚝壙廣彍懬懭擴曠櫎瀇爌獷癀矌礦穬纊鄺鑛𠢹𤒼𤳱𩑈𩧉𪇵𪍿
[广]	㲿圹广扩旷犷矿纩邝
広	広拡昿砿鉱
延	㝚㢟䀽䗺䘰䩥唌埏娫延挻梴涎烻狿硟筵綖脠莚蜑(𦿸)蜒誕诞郔鋋駳鯅𤥻𦧝𨒂𩃀𫄧
蛋	蛋
廷	㹶䅍䩠䯕䱓侹娗庭(榳)廷挺梃涏烶珽筳(䗴)綎脡艇莛蜓誔鋌铤閮霆頲颋鼮𨑳𪊶𬘩
建	㯬䊕䭈健建揵旔楗毽湕煡犍睷腱踺鍵键鞬騝鰎𤧣
廾	㫒廾
廿	卄廿
弁	㭓㳎㺹䒪䣲䪻䮁匥峅弁拚昪桳笲貵軬(䉊撪)閞鴘𨚕
畚	㨧㮥畚輽
弃	弃
棄	棄𠾍
弄	㑝㛞㟖㢅㳥㺯哢弄挵梇硦𠑋𠸙𡫶𢌊𢌌𢚸𣼰𤯨𤯩𤲌𤿰𥧪𥨋𦡠𧋼𧚠𨁦𨓡𩀳𩩖𪔠
弇	啽媕弇揜渰葊鞥黭
弋	㚤䄩䘝䣧䬥䴬弋杙浳甙芅貣釴隿骮黓𠯅𢖺𢩮𤴵𦏵𧿑𬬩
忒	忒脦鋱铽
聀	聀𠺵𢟘𢲦𤹚
式	侙式弑弒恜拭(𢁊)栻烒試(𤀏)试軾轼鉽𠲧𤞔𥅞
弓	䩑宆弓杛芎𡉖𢏢𢏣𥫤
弔	䘟伄弔盄鈟𠰀𢟛
吊	吊屌銱铞𠜏𠲢𢬢𦛉𨀽
引	㽼䀕䇙䏖䒡吲引弞矤矧粌紖纼蚓訠鈏靷𣏖
弗	㔗㚕㪄䀟䄶䛍䞞佛(𡌅)刜咈坲岪弗彿怫拂昲柫氟沸炥狒疿砩笰紼绋胇艴茀鉘髴鮄𡶒𩂕
費	㩌㵒䊧曊費鄪鐨靅
费	费镄
弘	䡏䨎宖弘泓(霐)紭苰鞃𢫠
弟	㖒㣢䏲䑯䬾䶏俤剃娣弚弟悌挮梯涕焍珶睇祶稊(蕛)第綈绨罤苐豑递銻锑鬀鮷鵜鹈𡌡𢚖𧋘
[⿱屮又]	㞵㫞弢詜
弦	㡉娹婱弦惤誸𦱁
弭	㥝弭渳葞麛
弱	䐞䚥嫋弱愵搦榒溺(𡀡𡣄𦡥)篛糑蒻鰯鶸
[強]	䥒勥嵹摾漒犟糨膙蔃襁謽鏹𡠤𣚦
强	䃨强繦镪
強	強繈
弼	㢶㢸弻弼
彑	彑
彐	彐
[彔]	㖨㪖㫽㯟䎑䎼䐂䘵䚄䟿䩮䱚娽椂氯琭盝睩碌箓粶菉觮趢逯醁騄鵦龣𢮑𩓪
彔	彔淥綠(𡂎)𤊒
录	㟤录渌緑绿𫘧
[剝]	䃗
剝	剝
剥	剥
[祿]	䴪簶𤳨
祿	祿𤀓𤐠
禄	禄
[錄]	籙
錄	錄
録	録
彖	㑰㥟㻹䂕䛹䞼䤸䧘(墬)䱲剶喙堟彖掾椽湪猭瑑盠禒篆(𢸢𥌫)緣(櫞)缘(橼)腞蒃蝝褖餯鶨
蠡	㒩㼖䗍䤙劙攭欚蠡𦧽
彗	㨹㻰䵻嘒彗暳槥熭篲蔧轊鏏𦒄𬭬
慧	㩨㬩䎚䡺嚖慧懳櫘譿𥶙𨯚
雪	樰膤雪鱈鳕𠽌
彘	彘璏
[彝]	㰘
彝	彜彝
彞	彛彞
彡	㣌䀐䑣䚲彡杉(涁)肜衫(𥓸)釤钐𪓫
彤	彤浵烿蚒
[彦]	偐喭嵃楌諺遃齴𩜽㘖
彦	彦谚顔(𤄰)颜𠦳𢞆𢢋𢱘𢵲𦞎𨩱
彥	彥顏
彪	彪滮𤹼𧜺
彬	彬虨霦
彭	㱶嘭彭憉澎甏膨蟚蟛𢵓𨭌
彳	彳
伇	伇坄役(䓈垼)炈疫豛鈠
後	後
徙	㿅嘥屣徙漇簁縰蓰褷蹝𢳜
從	㗰㙡㜡㞞㢔㹐㼻䐫䗥䙕䡮䢨䰌䳷傱嵷嵸徔從慫摐暰樅漎熧瑽瘲瞛磫篵緃縱聳(𡄭)蓯豵蹤鏦
従	従縦𫞋
御	䥏御禦(籞蘌)篽蓹
䘖	㗸䘖䘘
微	㜫㣲㵟䉠䥩嶶幑微徽徾癓矀薇覹霺鰴黴鿦
[⿰⿳山一几攵]	媺溦
徵	徴徵懲瀓癥藢𤑈
[⿰⿳山一王攵]	澂
[⿰育攵]	㬚㯙䒆徹(勶)撤澈瞮轍辙𠾀
心	㤈伈吢吣孞心抋杺沁芯訫鈊𡉾𢙭𣅵𤆸𥹀𥿂𦙦𨠉𩂈𩵽
必	㘠㧙㳴䀣䏟䖩䛑䟤䩛䪐䫾佖咇妼必怭柲毖泌珌祕秘(𦷬)苾虙袐覕邲鉍铋閟飶馝駜鮅鴓𢞵𤇩
志	䄊䏯䓌娡志梽痣綕覟誌鋕鿵𢙺𧋺
忝	㖭㮇䋬婖忝悿掭沗添舔菾𡍞𩡋
念	㑫(𤹑)䂼䧔䭃唸埝念惗捻敜棯淰焾稔(𡀝𣿇)腍艌菍諗谂趝踗錜騐(𤼔)鯰鲶𦁤𧛋
忽	㧾㺀䓤䨚䬍唿忽惚淴鍃锪
思	㴓䚡䞏䰄偲媤崽(㩄)思愢揌楒毸禗緦缌罳腮(𥵖)葸諰鍶锶顋颸飔騦鰓鳃𥯨𦖻
恖	恖顖
恩	䅰嗯恩摁煾蒽𡟯𤨒𤹕
息	㮩㴧䭒媳息熄瘜蒠螅鄎鎴
悉	㗭㣰㴽䊝僁怸悉窸蟋鏭𠞹𢴑𤎕𦄵𨄠
悤	䡯䧭傯幒悤憁摠(䉥)樬漗熜牕璁窻總(𤄋)聰蔥蟌謥鏓驄骢𦪐
怱	㷓䆫䈡䗓偬怱愡揔楤牎緫聦葱(憽檧濍燪繱)鍯騘𡟟𤧚
忩	㥖䐋䓗䙂倊忩捴棇焧窓総聡
总	总搃縂聪
惠	䧥僡寭惠憓橞潓璤穗繐蕙蟪譓鏸韢𬤝
恵	恵穂𨫍
惢	惢橤繠蕊(蘂)
意	䖁䗷䪰億噫嬑悥意憶檍澺燱癔繶臆(𡄯)薏譩醷鐿镱鷾𢶶𫄷
愛	僾噯嬡愛懓曖燰璦皧瞹薆鑀靉鱫
爱	叆嗳嫒暧爱瑷
感	㙳䃭䉞(𥍒)䜗䫲感憾(𡄏𥩇)撼澸轗鱤鳡𥽇
慮	儢勴慮攄櫖濾爈藘鑢𡃖
虑	摅滤虑
慶	慶櫦羻
庆	庆
憂	㱊䜡䥳優嚘憂懮櫌瀀獶瓇纋耰鄾
憲	㦥䘆䜢䧮幰憲攇櫶瀗藼𥌷
戈	㳀䄀䣬划戈戓戤牫鈛鳶鸢𠯫𣏾𦨜𩚧𩾷𩿙
找	找
戉	㞽㧔䋐䎀䟠䬂怴戉泧狘眓鉞钺魆𡛟𧊎𩿠
越	樾越𢵼𣾼𦅲𧑅𨅿𨬓𪆧
戊	戊茂(𢰝)𣳡𤇦𩂟
戌	㖅䎉䢕䬄戌珬銊𢬮𤇳𧧐
戍	㲓㳚戍荗
戎	㣝㭜䄾䘬䯷娀戎毧狨絨绒羢茙駥𠈋𠲦𡊸𢫨𣴛𧊕𧻪𨀻𪀚
成	㼩䫆城娍宬峸成晟晠珹盛(墭𣛮)窚筬絾荿誠诚郕鋮铖鯎𡷫𥓉
我	㧴䄉䖸䞲䳗䳘俄哦娥(𠹷)峨峩我涐珴皒睋硪莪蛾誐鋨锇餓饿騀鵝鵞鹅𤘋𧚄
戒	㑘㖑㳦悈戒械祴裓誡诫駴𢬿𤈪𤞫
戔	㟞㣤㥇㹽䎒䏼䗃䙁䧖䴼俴剗帴戔棧(嶘𥖔)殘(䉔)淺(䔐𠽈)牋琖盞碊箋綫菚虥虦諓賤(㰄濺)踐輚醆錢(籛)餞馢
戋	刬戋栈残浅盏笺线贱(溅)践钱(篯)饯𥒎𬣡
㦮	㦮䇳䬻桟賎銭
或	㖪㚜㰲㳼㽣䂸䈅䤋䧕䬎䮙䰥䱛域(𪅫)惐惑或掝棫淢(㵄)琙稢窢緎罭聝蜮閾阈馘魊𠒬𤊨𤦂𤷇𨨅
彧	彧稶𢒰
戚	㗤㞝䗩䙘䠞傶嘁墄慼慽戚摵槭磩縬蹙(㰗䙯)鏚顣
戛	嘎戛𢟟𣼸
戞	嘠戞
戜	䟈戜鐵驖
戟	㦸戟撠橶𠽤𡚄
戠	嬂幟戠樴熾(𢹊)織職(蘵𤼕)膱蟙識(𧄹)軄𢡠
截	㵶䕙䘁䟌䥫䰏䶪嶻截擮蠘𡁶
[⿰雀戈]	㘍巀蠽
戴	戴瀻襶
戶	㣗㦿(淭)䋀䋆妒帍戶户戸戽护昈沪粐舮芦鳸𢩜𣱆𩿇
扈	㨭扈槴滬熩簄蔰
雇	僱雇顧𤺮
所	㫹乺所齭𢀦𢯢𣷲
顾	顾
戾	㑦㪐㴃䈆䓞唳悷戾捩棙淚睙綟蜧錑𩸭
戻	戻涙
泪	泪
扁	㓲㞈㲢㴜㻞㼐㾫䐔䡢䭏偏匾媥徧惼扁揙斒楄煸牑犏猵甂碥稨(藊)篇糄編编翩艑萹蝙褊諞谝蹁遍鍽騗騙骗鯿鳊鶣𡎚
癟	癟
瘪	瘪
扇	䡪䥇䦂傓扇搧煽謆騸骟𠞛𥔱𨃩
手	手杽
才	䊷䌶䞗䴭才材犲豺財财釮鼒𦨑𩵝
折	㑜㝂㪿㿱䀸䀿䇽䋢䏳䓆䟷䩢䭁䱑哲(𠹗𡏥𣻂𥉭𦄃𧎴𩺢)哳埑娎悊折晢晣梊歽浙焎狾硩蜇裚誓(𡂉)踅逝(𩻔)銴𣩁𣩂𤄌𧋍
抛	抛拋𠴋𤽵
拜	㗑拜湃𢱎
[⿱巛夕]	㭮㳨拶
掃	埽掃
扫	扫
支	㞿㩼㩽㲍㽻䃽䚳䞚䡋䣫䧴䰙伎吱妓(𣇠)屐(𢲈)岐庋忮技(庪𠴜𢴛)支攰攱枝(㟚)歧汥秓翄翅肢芰(䝸)蚑衼豉(𠽑)跂鈘頍馶鬾鳷𢺹𢺺𥑂𥽤𦷨𨙸𩂏𩵾𫠆
攸	㛜㫍㫦䀺䖺䩦䱔倏倐峳悠(滺)攸浟焂筱絛翛莜跾鋚鞗鯈𠳘
條	條樤滌窱篠縧蓧螩鎥鰷𠺧
脩	䐰䗛樇滫脩蓨鏅𪅭
修	㹋修蓚鎀𡪇𥱤
儵	㶖䨹儵虪
条	条涤筿绦鲦𡸇
敄	㡔㮘䋷䓮䜼䨁䱯堥婺嵍愗敄暓楘瞀(霿)蝥鍪霚鞪騖骛鶩鹜
務	㜈䥐䳱務奦熃蓩霧𥊦
务	务雾
敏	䲄慜(𧁋)敏鰵鳘𠍁𠽊𢄯𢠨𥼖𪄴𪉾
敕	䔩勅慗敕潄瘷遫鷘𣙙
敖	㜜㟼㠂㥿㾲䦋䫨䮯䵅傲嗷嗸嫯嶅廒慠摮敖滶熬獒獓璈磝聱蔜螯謷謸遨鏊隞驁骜鰲鳌鷔鼇𢳆𣊁𦪈𧑃𨎞𨫼
敝	䌘䠥䥕䨆嫳幣弊(𡃇)彆徶憋撆撇敝斃暼潎獘獙瞥蔽蟞襒蹩鄨鐅鱉鳖鷩鼈(虌)龞𠟈𬭯
币	币
敞	僘厰廠敞氅𢠵𤺲
敢	㒈㜟㦑㺖䧩䭛噉憨撖敢橄澉瞰譀豃闞(㘚矙)阚(㘎)饏鬫𡑒𥼲𨅺
㪔	㪔
散	㪚䃟䉈䨷撒散橵潵潸糤繖鏾霰饊馓
敦	㪟㬿䃦䔻䪃噋墩墪憝憞撉撴敦暾橔潡燉犜獤礅譈蹾鐓鐜镦驐鷻𧑒
[享]	䇏啍埻弴惇淳焞犉稕諄谆醇錞鶉鹑
敫	㦘㰾䁶䚫䥞儌噭墽嬓徼憿撽敫曒檄激燩獥璬皦礉竅(𨇶)繳缴薂覈譤譥躈邀鸄𣎣
敬	㢣㯳䜘儆憼擎(𨰈)擏敬曔檠璥蟼警驚
文	㞶䘇䰚伩呅坟(𢭷)妏彣(珳)忞忟抆文旻(㥗渂琝)旼汶炆玟玫盿砇紊紋纹芠蚉蚊螡雯馼魰鳼鴍鼤𡲈𣐀𤝋𩖰𪊓𫌴𫘜
斗	㖍㘰㞳㪲㪳㪷㳆㺶䀞䚵䢏乧抖(唞)斗斢枓紏蚪鈄钭閗阧鬦﨣𢗸𤓺𧿫𩿚
料	䉼料炓窲𠺫
斛	㩂䈸嘝斛槲蔛𡐗
斤	㸫㹞(䓄)䖐䜣䤱伒劤听(𥺐)圻妡岓庍忻斤斦斫斬斳旂昕沂(䇵䓅垽峾)炘盺祈紤肵芹(𣔠)蕲蘄(玂鄿)蚚訢赾近(菦𠶌𣷯)邤釿(䤺)靳(龩)頎颀馸齗龂𥬊𧵆(𠼹𦹱)𬬱
欣	俽惞掀欣焮鍁锨𣔙
斥	㿭䞣䟟坼拆斥柝蚸跅
斬	㜞㟻㨻䁪䟅䭕䱿䳻塹嶃嶄慙慚摲斬暫(𡗎𧔜)槧獑磛蔪螹覱蹔鏨鏩𥕌𦗚𦗝
斩	堑崭惭斩暂椠渐錾
漸	䤔壍嬱漸聻魙
斯	㒋㯕㽄䔮䡳䲉凘厮嘶廝撕斯澌燍簛蟖蟴鐁𡡒𩅰
新	㜪噺新澵薪
斲	斲斵鬭(𡆞)
斷	㫁䜝䠪斷籪𩪽
断	断簖
方	㕫㝑㤃㧍䄱䢍䲱仿坊妨彷房(椖𠉱)放(倣𤊦)方昉昘枋(堏)汸(𩃎)牥瓬眆祊紡(鶭)纺肪舫芳(淓錺)蚄訪访趽邡鈁钫閍防(埅)雱髣魴鲂鴋𢁸
於	㫇㫈乻唹扵於旕棜淤瘀箊菸閼(𤂷)阏𣄒
施	㒾㻢䗐崺揓施暆椸湤箷葹鍦𠷇𦂛𧩹
斿	䑻斿游(𣛦)蝣遊
旁	㥬㿶䄘䅭䒍䠙䧛䨦䩷傍嗙塝嫎嵭徬搒旁榜滂(霶)牓磅篣縍耪膀艕蒡螃覫謗谤鎊镑騯髈鰟𤧭𤹔
㫄	㫄㮄
旅	㭚䮉旅玈祣膂
旋	㯀㳬䁢䃠䗠䲂嫙旋暶漩琁璇縼蔙蜁鏇镟颴
族	㵀䃚嗾族瘯簇蔟鏃镞鷟(𡆈)𩺯(𡆍)𬸦
无	䥻呒妩庑怃抚无芜𣲘
旡	旡炁黖
[既]	㮣䀈䇒䊠䐴嘅慨(𡁙)摡槩[暨](櫭)穊蔇鱀𡠣𤡚𦔙𧑂𩯂𩺺𪖺
既	塈既暨概溉𬶨
旣	墍旣曁槪漑
日	㒲䒤䖑䵒抇日汨衵鈤馹驲𡥌𧿭𨑨
旦	㡺㫜䋎䖧䜥䞡䦔䱇䵣但(𠜬𢭱𨧝)呾坦(𢯟)妲(𧶬)怛(𠝗𠶒𦝇)担(𠵆𦏄)旦柦泹炟狚疍疸笪(𢴈)胆袒觛詚鉭钽靼鴠𠛣𠡎𠿲𣌛𥅃𥑲𦤾𧩙𨀏𩑰
旨	㚛㞓㞛㸟䭫䭬恉指旨栺脂(㴯)詣诣酯鮨鴲𦮂
稽	㮷嵇稽𠺳𡃊𡓈𥗎𦪼
早	早皁
皂	唣梍皂
草	愺草騲
旬	㝁(惸(𥖒)賯𠊫)㡄㧦㫬㰬㶷䀏䖲䘩侚咰姰峋徇恂旬栒殉毥洵珣眴筍(㒐橁)絢绚荀(㨚䜦槆)詢询迿郇銁銞駨
旱	㪋䏷䓍䛞䳚哻垾娨悍捍旱晘桿焊(蔊)猂皔睅稈筸貋趕銲駻
昆	䃂䅙䊐䐊䚠䛰䵪倱堒婫尡崐崑(潉熴)惃掍昆晜棍混(𠽞)焜猑琨窤箟緄绲菎蜫裩輥辊醌錕锟餛馄騉鯤鲲鵾鹍𠝕𡥵𣙹𪂳
昌	䅛䗉䞎䮖倡唱娼昌晿椙淐焻猖琩菖裮誯錩锠閶阊鯧鲳𩩪𩩫𪂇
明	䳟奣明盟(擝)萌(橗𢅆)𢜏𢜠𣷠𥯋𦁠
囧	㴄囧朙莔
昏	㖧䎽䫒婚崏惛捪昏棔殙涽焝痻睧碈緍錉閽阍𧍎
昬	㗃㛰㟭㨉㬆㱪䁕䃉惽昬暋湣瑉緡缗鍲𩔉
易	㑥䯜剔埸惕敡易晹痬睗緆舓蜴裼賜(儩)赐踢逷錫锡鬄
昔	㛭㝜㟙㳻䄍䇎䜺䧿䱜借(𠺦)剒厝(䥄)唶庴惜措(簎)斮昔棤焟猎瘄皵矠碏稓耤(䎰䣢籍藉(躤))腊蜡諎趞踖逪醋錯(𡓠)错鵲鹊齰𣈏𧛊
㫺	㫺䥘𢵄
昜	㼒䁑䑗䵮偒啺場婸崵愓揚敭昜暘(霷)暢楊(鸉)氱湯(燙璗盪簜蕩(蘯𢥉)鐋)煬瑒畼瘍碭(𦿆)禓糃腸蝪諹踼輰(𡒮)逿鍚陽颺餳鰑𤋁𦳝𧼮
[⿱𠂉昜]	傷塲慯摥殤(薚)觴
[⿹𠄎⿰丿丿]	场扬旸杨汤(烫荡铴𬍡)炀玚畅疡砀肠钖饧
[⿱𠂉⿹𠄎⿰丿丿]	殇觞
伤	伤
阳	㳱阳
星	䃏䗌惺(㝭)戥星暒曐湦煋猩瑆睲篂腥謃醒鍟鯹𦎬𦖤
春	㖺㿤䐏䞐䦮䮞䲠偆堾媋惷春暙椿(𢢫)湷瑃睶箺萶蝽蠢(𡆂𤅧𧕷𨙥)賰踳鬊鰆𢰦𨩃𪂹
是	㓳㔭㖷㮛㼵䅠䈕䊓䐎䚣䜻偍匙(𣼮)堤媞寔(㵓)崼徥惿提(䔶䶶𠤧𠽮𣾸)是湜煶瑅睼碮禔緹缇翨蝭褆諟趧踶遈醍鍉隄鞮題(禵𤄭)题騠鯷鳀鶗𫘨𬤊
昰	昰𧡰
昱	䗑喅昱煜
[𥁕]	㬈㼔䯠嗢塭殟瑥瘟蝹褞豱鎾鞰韞饂馧𥠺𩥈
昷	媪愠揾昷榅氲温(蕰𡀦)煴緼(藴)缊(蕴)腽蒀輼辒醖韫鰛鳁
𥁕	媼慍搵榲氳溫(薀)熅縕(蘊(𢺝))膃蒕轀醞鰮𥁕
時	塒嵵時榯溡蒔鰣𠺮𥱯𨫉
时	埘时莳鲥
晃	㨪䁜幌愰晃晄榥滉熀縨鎤
晉	㬜戩搢晉榗溍瑨縉鄑
晋	㬐戬晋缙
晏	䁙䨃晏暥騴鷃鼹𠹵
晝	晝
昼	昼
普	䲕普氆潽譜谱鐠镨𠽾𦡮
晶	晶橸𣇵
暑	暑濐鱪龧
暴	㩧㫧㬥㬧㿺䂍䤖儤嚗懪暴曓曝瀑爆犦襮謈鑤鸔𦢊𧔙𩙕
曄	墷曄曅(爗)燁皣瞱
晔	晔烨
曇	壜曇罎𦉡
昙	昙
曰	䫻抇曰欥汩蚎𤵖𥿀
曲	㖆㤟㻃䒼䢗曲浀筁粬蛐髷麯𨦈
曳	㖂㡼㹭䄿䇩䎈䒶䛖拽曳曵栧洩絏跩齥𠻇𤲼𤵺𥹞𧻭𧽇𧽈𨱽
更	㹴㾘䢚哽埂峺挭更梗(𠼰)浭硬稉筻粳綆绠莄郠鞕骾鯁鲠𣆳𦑃𧣲𨁈
㪅	㪅䌄
曷	㓭㔠㡫㷎㹇㿣䅥(藒)䈓䋵䦪䨠䫘偈喝堨嵑幆愒揭(䔾䥟)暍曷朅楬歇(蠍𠿒𤢔𪗀)毼渴(㵣䔽)猲碣竭羯蝎褐(䕣)謁(藹靄)谒(蔼霭)輵遏(𣜶𣿌)鍻鞨餲馤騔鶡鹖齃𣍊𤸎𥃞𦤦𩩲
葛	㵧䗶噶嶱擖獦礍臈葛轕𡑪
書	圕書
书	书
㯥	㯥
曹	㜖㡟㷮䄚䏆䐬䜊傮嘈嶆慒曹曺槽漕糟艚蓸螬褿蹧遭(㯾)醩鏪鰽𢲵𥕢
曼	㻴㿸䅼䊡䜱䝢䟂䡬僈墁嫚幔慢摱曼槾漫(䕕)熳獌縵缦蔓蟃謾谩鄤鏝镘饅馒鬘鰻鳗𠢝𠼦𢩤𥲑𩅍𪉽
㬅	㡢㬅澷
曾	㣒㬝㽪䁬䆵䉕䎖䒏䙢䰝僧噌増增層(𥶰)嶒憎曽曾橧潧熷璔甑矰磳竲繒缯罾譄贈(囎)赠蹭鄫鏳驓鬙𤺧
层	层
替	㬱僣暜替鐟
最	㵊䴝嘬撮最樶熶穝繓蕞襊𢢇𣋁𥊴
朁	㔆㣅㦧㻸㿊䁮䃡䅾䍼䐶䣟䣠䤐䫬䭙僭(𠠭𧹿)噆嶜憯撍朁橬潛潜(𢸝)熸簪(𡅎𢹽𣠱𨇸)簮糣蠶譖(𥸄)谮鐕𩻛
昝	偺喒揝昝糌
會	䢈䭝䯤䵳䶐儈劊噲嬒廥懀旝會檜澮燴獪璯癐瞺禬糩繪膾薈襘譮鄶鬠鱠𠁚𡳳𢶒𣍋𣞄𥖩𥢶𦓊𨆝𩠴
会	㻅会侩刽哙桧(𦷭)浍烩狯絵绘脍荟郐鲙𡋗𡳃𩠠
月	㳉䄴䎳䚴䢁仴刖岄抈月枂玥肷蚏跀迌鈅钥𣌴
外	外夞迯𠰻𡎢𡎥𡎦𢫑𣳢𨀑𩠘
有	㤢䀁䆜䒴䞥䳑䵋侑哊囿姷宥峟戫有栯洧烠珛痏絠蛕詴賄贿迶郁(㮋喐𣹙)酭銪铕鮪鲔𢒰𨚼
朋	㥊㻚䙀䨜倗堋奟弸掤朋棚淜焩痭硼稝綳绷萠輣錋鬅鵬鹏𥦜𧌇𨂃
服	服棴箙菔鵩
𠬝	𠬝
朔	㮶嗍塑愬搠朔槊溯蒴遡鎙𥉮𪇐
朕	㮳㴨䲢勝(橳蕂)塍(堘畻)媵幐朕榺滕(漛籐藤)縢(䕨籘)腾膡螣謄(誊𧬸)賸騰(䠮儯虅駦驣)鰧黱𠹻𣞅𨃵𨫇
[关]	栚浂眹
灷	㑞灷
朝	嘲廟朝潮謿𠎫𢀭𢢅𣊿𣋂𣎢𣛨𦺓𨅹𨗛𩻹
庙	庙𠶦
木	㕲㭉䊾木朰沐(莯霂)炑狇蚞鈢雬𠚐𠣛𡉿𢪮𥄢𦙣
未	㖝㭑䙿䵢佅味(菋)妹(𠵈)寐怽抺昧未沬眛祙苿跊魅鮇𣒠𥞊
末	㶬䍪䏞䬴䱅䴲唜妺帓怽抹昩末枺沫皌眜砞秣粖茉袜靺韎𠅍𠅒𠖾𠰌𡘮𩈘𩗂
本	㡷㤓㶱䬱呠本泍砵笨絊缽(𠼭)翉苯鉢钵𠄯𡭦𢫆𤵳𦊚(𥻸)𦏓
朮	㺷㾁䘤䟣怵怷朮术沭炢秫(䢤)絉術(𦸇)訹述(蒁鶐𣉐)鉥𠰲𡊍𢫖𤝞𬬸
朱	㦵㧣㸡㼡䇬䎷䏭䣷侏咮姝朱株殊(𢲬𭉝)洙珠(𠺾𢟐)硃祩秼絑茱蛛(𦅱)袾誅诛趎跦邾銖铢陎駯鮢鴸鼄𤊣𤝹𤶎𥅲
朵	㛊䤪剁哚垛挆朵趓跺躲𡇙𣳼𧊶
朶	㛆䒳刴垜尮挅朶桗跥躱
朿	㞖㢀㭰㾊䊂䟱拺朿栜洓茦
策	㩍憡策鏼
刺	刺刾箣莿
敇	敇蓛𥰡
[亦]	跡迹
李	李
杏	杏莕
束	㑛䜹凁娕悚捒束梀殐涑竦綀脨觫誎趚鋉餗駷𠲿𥟈𥢉𧆄𫗧
欶	嗽摗樕欶漱瘶簌蔌遬(藗)鏉
速	㯈䔎䲇速𩅘𩯀
東	㖦㨂㼯䍶䰤䵔倲凍(𢟞)埬娻崠崬東棟氭涷腖菄蝀諌鯟鶇
东	㑈东冻岽栋胨鸫𬟽
杳	杳
松	㟣䘴倯凇崧松淞硹菘蜙鬆𥯆𩃭
析	㭊㱤䨛唽惁晰晳析椞淅皙菥蜤蜥
林	㑣㛦㝝㨆䢞䫐冧啉婪(漤𠼖)崊惏晽林棽檒淋(䨬)琳痳碄箖綝罧菻諃郴醂霖(瀮)𠄻𡍚𤊩𤾓𥦝𦝃𧹫𨂕𬘭
枚	枚𠦩𠶣𡮋𢆧𢆨𣈕𥯍𦁼𦩚𧛉𨨦𩘄𩜫𩸳
果	㚌㞅㪙㷄㼫㾧䂺䴹倮堁夥婐惈捰敤果棵(䉓)淉猓祼稞(䊬)窠粿綶腂菓(𢵵)蜾裸(𤁖)裹(䙨)課(𢸠𣋾𥌥)课踝躶輠錁锞顆颗餜馃騍骒髁𠵩𣇫𩸄𪂠
枼	㳿㻡䁋䈎䐑䑜䚢䢡䭎偞喋堞媟屟屧幉弽惵揲枼楪殜渫煠牃牒(䕈䥡)碟緤艓蝶褋諜谍蹀鍱鞢韘鰈鲽𩄓
葉	㵩䜓䭟僷擛瞸葉蠂鐷𠪸𠿚𢢲𣋑𣜿𨆡𩆏𩍣
枽	枽𫟒
某	㖼䗋䤂媒(𠿃𥴘)某楳湈煤禖腜謀谋𠋦𠝺𡎡𡮘𢃱𢱖𦨂𦳑𧗅𨪀𩝇𩹮𪃏𪉴
染	媣染蒅
柔	㑱㖻㽥䋴䰆媃揉柔楺渘煣猱瑈糅腬葇蝚蹂輮鍒鞣韖騥鰇鶔𫐓
查	㜁㾴喳嵖揸查査楂渣猹皶碴蹅餷馇齄𠾵𣉎𥻗𪃵𪙁
柬	㪝㱫㼑堜媡揀暕朄柬楝湅煉瑓練萰諫(𠣂)谏鍊(𡄮)鰊𢒞𣍃𥈵𥻂𧍴𬶠
[⿻⿻𠃋一⿻𠃌八]	拣炼练
柰	㮏㲡柰渿𡞫
奈	㖠㮈㴎䱞倷奈捺萘錼𩜪
栗	㗚㟳㮚㯨䔁傈凓塛慄搮栗溧瑮篥鷅麜𣙬𤌣𥠲𨫊𩺤
桀	傑嵥搩桀榤滐謋𠹳𡩣𢷡𦵴
杰	杰
桑	䡦䮣嗓搡桑桒槡磉縔褬鎟顙颡𤌧
桼	㓼㯃䜉䣛䰍厀桼漆膝
梟	䲷嘄梟蟂鄡鷍𡂢𡏭
枭	枭
棗	棗
枣	枣
棘	㻷棘蕀襋
棥	棥燓
樊	䙪䫶攀(襻鑻)樊礬蠜鐢𡃎𥽢
森	㚞森潹𠎊𠾣𡑓𢵳𣛧𦼚𨅾
楚	儊憷楚檚濋璴礎齼𬺓
業	㗼㱉㸣䌜䧨嶪嶫擈曗業澲礏鄴驜鸈𨭥
业	业邺
樂	㜰㦡䁻䑈䟏䤕嚛擽樂櫟濼爍瓅皪礫纅藥(㰛)觻躒轢鑠鱳𧭥
乐	㧰䀥乐栎泺烁砾跞轹铄𬍛
楽	䃯楽檪薬(𣟿)
橐	槖橐蠹驝
欠	㐸㳄㸝䇜䊻䚿坎(崁莰𠥈)忺扻杴欠砍缼肷芡飲(𠿮𤀔)饮𣢹
次	䅆䨏䪡䯸䳐乲佽咨(㮞䠖楶趦𨩲)垐姿(㾳)恣栥栨次瓷秶粢絘茨諮谘資(䆅澬薋蠀)资趑餈𥸷(𠺼𩄶)
欮	欮瘚闕(灍)阙
款	㯘䄐䕀䥗䲌款歀窾
欵	欵窽
止	㱖䇛䊼䤠址扯(𠳏𨁘)杫止沚砋祉耻(𢲮)芷(淽)訨趾阯頉𠯽𩾰
齒	嚙鑡齒𠠚𢸡𤻽
齿	啮齿
正	䋊佂姃征(惩𣔥𦲵𨨨𩸵)怔政(䈣晸)整(𡓟)正泟炡症眐竀聇証证鉦钲阷靕頙鴊𢘫𦙫𧣠𨠣𩶝
此	㘹㠿㧗㧘㭰㰣䂑䂣䖪䘣䳄佌呰呲啙姕庛(㖢)此泚玼疵皉眥眦砦祡紪紫(䔝橴)胔茈(𣸆)訾訿貲赀跐鈭雌頾頿飺骴髭鮆鴜齜龇𥬳𫚖
些	㾚些𢧲
柴	㾹䓱䠕偨喍柴𣖧
觜	嘴蟕觜
步	㻉㾟䑰埗捗步歩荹踄𡝃𦁗𧌂
武	䝾䟼倵娬武珷碔賦赋錻陚鵡鹉𢯞
歬	歬
歰	㒊䔼歰澀澁譅
涩	涩
歲	䠩䮹劌噦奯檅歲濊獩穢翽薉鐬顪饖鱥𡻕𢆫
岁	㑕刿哕岁秽翙
歷	㠣㱹㺡㿨䍥䍽䟐䥶儮嚦壢攊櫪歴歷瀝(靋)爏瓑癧礰藶讈轣靂𣄬𥷒𧋇𧝦𧞿𨇗𨊛
㱕	㱕䢜𢵴
歸	巋歸蘬𢹾𣠗
归	岿归
歺	歺
歹	歹
死	死
殳	䟝䬦吺投(𡷠)杸殳砓祋竐軗酘骰
段	㱭塅椴段毈煅瑖碫緞缎腶葮鍛锻
㐆	㐆
殷	慇殷溵磤蒑
殸	㷫㿦䅽䡰殸漀磬罄聲謦鏧韾馨
声	声
殹	㗨㙠㬾㿄䃜䗟嫛殹毉瑿瞖繄翳(蘙蠮)贀醫(鿀𡄵)鷖鹥黳𧫦
殺	䊛摋榝樧殺蔱鎩𠺽𪄅
刹	䓭刹剎
杀	杀脎铩閷
煞	煞
殿	㩔壂殿澱癜臀𡑴𣫕𤩱𧓇
毀	㩓檓毀毁毇燬譭𤻏
毄	墼擊(𥗩)檕毄礊繫(蘻)罊蟿轚
击	击
毋	毋
毌	毌
母	㑄㟂䳇呣坶姆拇栂母牳砪胟苺鉧𤝕𧿹𬭁
每	㙁䀲䊈䋦䍙䩈䱕侮勄娒悔挴晦(𤹾)梅(𠻽)毎每烸珻畮痗(𢵹)脢莓誨诲踇酶鋂霉黣𠜮𠳨𢙽𤗆𤞦𧋟𧖦𩛸𪉥𪖫𪖬
海	嗨海𢲨𤍃𥉪𦷫𩘫
毐	毐
毒	䓯毒瑇碡纛蝳𣕬𧛔
比	㘩㿫䃾䘡䚹䩃仳吡妣屁庇批枇枈比毙毞沘玭琵疪砒秕笓粃粊紕纰肶舭芘(𣓋)蚍豼鈚阰魮𨈚
毘	㔡㡙㮰䠘媲毗毘磇篦膍蓖螕貔鎞
毚	㜶㸥㺥䂁䜛䧯䪌儳劖嚵巉攙欃毚瀺纔艬讒(𡆙)酁鑱镵饞𧓰𩯯
[⿱免冫]	搀谗馋
毛	㕰㘪㚪㧌㲏㲝㿞䋃䚽䫽䭷旄枆毛毣氂牦眊秏耄耗(𣉶)芼覒軞酕髦𠇔𣭻𤆬𦙤𨖧𩠔𩿘
毳	㦌㯔䄟撬橇毳竁膬𣾽
氏	㞴㡳㹝䉻䟗䲬䲭坁帋(𧚓)忯扺氏汦(䓋)疧眂祇秖紙纸舐芪蚔衹觗赿軝𣏚𨸝𬨂
氐	㪆㫝㲳䍕䑛䟡䢑䩚䬫低(𠴓𡌠𦰣)厎呧坻奃岻弤彽怟抵柢氐泜(䓜)牴疷眡砥祗秪羝胝茋蚳袛觝詆诋貾趆軧邸阺骶鴟鸱𦨢
底	㭽䣌底掋菧𡞖𣷳𤯰𤯿𥓵𦝉𧍉𪂰
民	㢯㥸䂥䋋䛉䟨䡑䪸刡呡垊姄岷怋抿敃(㟩愍暋睯)民泯珉眠笢罠苠蟁鈱鴖
气	㐹㧉㪂㰟䏗刏忥忾气汽芞饩𣱚
氣	㑶愾暣氣滊熂犔鎎霼餼𠺪
水	㝽㲻㽷水沝𢗷𣲙𥤼
氶	㞼氶
丞	㷥䇰䒱(䕄)䡕丞拯(𩄔)洆烝(篜蒸)脀
承	㴍承
永	咏栐永泳詠𠶇𢫕𦕟
氾	䀀氾犯笵範范
求	㛏㞗㟈㤹䟵䣇俅捄救(慦)梂殏毬求浗球皳盚絿脙莍蛷裘觩賕赇逑銶鯄𥆿𨱇
[⿱囘又]	歿沒
[殳]	殁没
[沒]	莈𧋶
沓	㛥㧺㭼㹺䂿䈋䍝䎓䓠䵬䶁崉沓涾濌誻踏(𧃌)錔鞜𠴲𧛆
沙	㲚㸺䣉䤬乷唦娑(䓾)挱(莏)挲桫桬沙猀痧砂硰紗纱莎裟逤閯髿魦鯊鯋鲨𧋊
泉	㟫䤼泉湶灥瑔線缐腺葲闎(灁)騡鰁鳈
法	䦢法灋珐琺鍅𠵽𦝌𦝎𦲾
波	㨇啵婆(嘙蔢)波碆箥菠錃𢯠𨨏𬭛
津	堻津葏
𠂢	㭛䖰䤨哌挀眽衇𠂢
派	派蒎鎃𢄃𤋻𦞓
脈	脈霢
脉	䳮脉霡
涉	䤮涉渉
[⿲丿⿳八一八丨]	䨊婣棩蜵裫鼘
淵	㘤奫淵鼝
[⿲丿米丨]	
渊	渊
淼	淼
渠	㣄䝣渠璖磲蕖蟝𠹱𪆫
火	伙吙火煷邩鈥钬
灰	㞀㷇咴恢(䈐)拻洃灰烣盔脄詼诙𦤠
災	災
灾	灾
炎	㲜㷋䊏䎦䗊倓剡啖埮婒惔扊掞敥晱棪毯氮淡(䆱𠻪𢴗𥊗𧐽𨤵)炎焱燄燅(㰊䕭)琰痰睒緂腅舕菼裧覢談(𡃘)谈賧赕郯醈錟锬顃餤𨤮
炙	䂹炙
炭	㛶㨏湠炭碳
烏	㮧䃖䖚䡧嗚(𤀙)塢嵨摀(𡀴)歍溩烏熓瑦螐鄔鎢隖鰞𠌥𥻼
乌	乌呜坞邬钨
烕	㓕搣滅(𢷄)烕𦄅
灭	灭
焉	㥼㯊䗡傿嘕墕嫣漹焉篶蔫鄢
焚	㷊焚
無	㒇㷻䉑䌗䍢嘸墲嫵幠廡憮撫(𧁵)橅橆潕無璑甒瞴膴蕪蟱譕鄦鷡𠓺𨅐
舞	㵲䒉儛舞躌𢷵
焦	㲬㺘䆶䌭䩌僬劁噍嫶嶕嶣憔撨樵(藮𡃼)潐焦燋燞癄瞧礁穛(䕴)膲蕉(櫵爑)蟭譙谯趭醮(蘸(𡆖))鐎顦鷦鹪𥼚
然	㒄㜣㦓㬗䔳䳿嘫撚橪然燃繎蹨𡮫𤡮𤺱
煩	煩薠
烦	烦
熊	熊
熏	䗼䙧勲(𤑛𬟓)勳(爋蘍)嚑壎曛櫄熏燻獯矄纁臐薫薰(䌲)醺鑂𫄸
𤇾	㽦䁝(㹙)䎕䪯塋嫈嬫嵤檾滎(濴)焭(㒌橩)煢熒(濙藀)瑩(㼆瀅𥗏)甇禜縈(潆瀠礯)罃螢(㶈)褮覮謍醟鎣(灐)鶯𡦃𤇾
榮	㘇㩞儝嶸榮濚爃蠑鑅𠓐
營	㹚㿘巆攚櫿瀯營𢥏𤫎
[⿱艹冖1]	䓨茔茕荥荧莹(滢𬎆)莺萤营萦蒏蓥
荣	㮠嵘溁荣蝾𠓅𤾔
燕	㬫㷼䜩䴏嚥嬿曣燕臙觾讌酀醼驠鷰
燮	㦪㰔㸉㽊夑燮爕躞𤫉
爪	㐍䖣䝖抓(𢱑)枛爪笊釽
[爭]	㬹䋫䍵䦛䱢埩婙棦琤碀竫諍踭錚鬇𠬉𠲜𢛵𦽰𧶄𨘱𩓞
爭	凈崢掙淨爭猙睜箏
争	䦶争净峥挣浄狰睁筝诤铮
爯	㛵偁爯稱(䕝)
称	称𠦿𠺰𨃾
爰	㣪㬊䁔䈠䐘喛媛嵈愋援暖楥湲煖(蕿)爰猨瑗緩(藧)缓萲蝯褑諼(蘐)谖鍰锾鰀鶢
[爲]	㬙㺔䃣䈧䞈䦱䧦噅噕寪撝蘤蟡譌鄬𡐮𥢬𦠽𦢳𧹋𩻟[蔿](儰)[僞](𠼮𧓯)
爲	僞嬀潙爲蔿
為	偽媯溈為蒍
为	㧑为伪妫沩𫇭
爵	㩱㬭䂃嚼灂爝爵皭穱釂𨰜
父	㕮㳇䭸斧(䗄𨨞)父蚥釜(㵚滏𪄇)𣏤
爻	㤊䂚䋂䒝䡈爻笅覐訤
敎	䃝嘋敎教漖𨬊
爽	㼽䔪䗮䫪傸塽慡摤樉漺爽磢鏯騻鷞𨄷
爾	䌤䕥儞壐嬭彌(㜷䥸瀰獼瓕)擟檷濔爾獮璽(㣆䌳𤿂)禰籋(㩶)薾襧趰邇鑈镾隬鸍鿛鿜鿝鿞鿠鿡鿥鿧鿨鿩𠧌𡁠𨤻
爿	䍧妝戕斨爿牀(𤷲)牂狀(𣈚𥇺𨡧)
床	床𠒥𠳹𤉜𦀾
丬	丬妆状
牆	牆蘠
[嗇]	墻嬙廧檣艢薔
[啬]	墙嫱樯蔷
片	㭊䏒扸沜片覑
牙	㤉㧎䄰䥺䪵伢厊(𧧝)呀岈庌枒牙犽玡疨砑笌芽蚜衺訝讶谺迓釾閕雅(蕥𠾒)颬鴉鸦齖𤆹
邪	䓉琊邪
牛	㭌䋅䒜汼牛𤙮
牟	䏬侔劺哞恈桙毪洠牟眸蛑鉾鴾麰𣭰𤚥𥭏
牡	牡
牢	㟉䜮哰浶牢窂𡫡𣇟𣋀𣒲𤚧𦰤𨦭
牧	牧
特	特
牽	㯠撁牽縴鏲
牵	牵
犀	㓾㜨䙙䜄墀徲摨樨漽犀穉𤺳
遲	䆈遅遲𡂙𢹌𥽩
犬	㧋汱犬猚畎
犮	㺴䣮䮂䯋䳁䳊冹坺妭帗拔(菝𧛌)柭沷炦犮盋瞂祓秡紱绂翇胈茇蛂袚詙跋軷鈸钹韍韨颰馛髮魃鮁鲅黻鼥
叐	㧞䟦𦭞
狂	㤮㾠俇狂誑诳逛鵟𧋵𨁨𫛭
狄	䯼唙悐梑狄荻逖
狊	䠐䴗湨犑狊瞁郹闃阒鶪鼳
猋	䁭䔸猋贆飆飇飊飙
猌	憖猌㙬憖猌𪙤
慭	慭
猒	猒
獄	嶽獄鸑
狱	狱𬸚
獸	獸
嘼	嘼
兽	兽
玄	㹡䍗䝮䩙䮄䲻伭呟妶弦怰昡泫炫玄玆玹痃眩絃胘舷蚿衒袨詃鉉铉
率	㻭䔞䢦摔率繂膟蟀𣘚𧗿𨄮𨙖
玉	䞝匤玉玨珏砡鈺钰頊顼鳿𢫛𣔣𪸛𫞂
王	㴏䍿䶭仼尪彺忹抂旺(𦁽)枉(㳹𠶖)汪(𠴝)狂王蚟軖迋𥿁
班	㿀班𠞢𠺚𢲔𨫄𩺡
斑	斑癍
瑟	濏瑟璱飋𩇣
[⿱⺌貝]	䐝䣔䵀嗩溑瑣鎖鎻
[⿱⺌贝]	唢琐锁
瓜	㧓㽿呱坬孤(箛菰𡍢𢮩𣔞𦁣𧍆𨂗𨔌𩸰𪂮𪂲)弧柧泒狐瓜畖窊(䠚搲攨溛)笟罛胍苽蛌觚(䉉)軱鈲𧵟𩛃𪀅
箍	箍
瓦	㧚㼘佤咓瓦砙邷𤬪𧧀
甘	㤌㶰㽍㽏䇞䗣䲺佄咁坩姏拑(㟛箝)柑(䈤)泔玵甘甝疳(𦟉𪒷)粓紺绀苷蚶詌邯酣鉗钳雸魽黚𤯆𥑠𦚕𧮳[⿰甘欠](嵌篏)
甚	㴴㻣䤁䨢䫖偡勘(墈磡𦤯)啿堪夦媅嵁愖戡揕斟(𨮊)椹(𦾢)歁湛(霮𠾻𢵺)煁甚瘎碪糂葚諶谌踸鍖黮𠝻(䉇)𥯓𦂼𧹱
甜	㵇甛甜
[舌2]	䀨䏦䑚恬(湉)栝狧銛铦餂
生	㽒䲼䴤夝姓性(𠶞)旌栍殅泩牲狌珄生甠甥眚笙胜苼貹鉎鮏鼪𠡏𡊳𤇣𤬸𤯭𤯺𥑥𦎡
産	㦃㯆㹌䊲䐮剷嵼摌滻簅鏟𨄉産產
産	産
產	產
产	产浐铲
用	㶲佣拥用痈苚𠖿𢘭𣳔𥙓𥞖𧊊𨀍
甫	㕊㭪䀯䊇䋠䎍䝵䩉䪔䮒䯙乶俌匍(葡)哺喸圃埔峬庯悑捕(蒱𥱴𧏳)晡浦(㜑䈬蒲(𨆶𩟢𪇨))烳甫痡盙(簠)秿脯(䈻䔕)舖舗莆(𨄳)蜅補(𠬕𠬖𡀨)誧豧輔辅逋郙酺鋪铺陠餔鬴鯆鵏麱黼𠬃𤙭𤞨𤿭𥮉𬷕
甬	㛚㦷㪌㷁㼧俑埇恿悀捅桶涌(慂)甬痛(𨪞)硧筩蛹誦诵踊銿鯒鲬𧚔𩊾
勇	䞻勇勈愑湧踴
通	嗵樋熥蓪通𢠆𦄷𦪏𧐺
田	㧂䟧䡒䧃佃屇榃沺田甸(䡘蜔)畋畑鈿钿鴫鿬𡊰𦹸
由	㐕㣙㹨㽕㾄䄂䌷䛆䜬䩜伷冑妯宙(𥇻)岫廸怞抽(菗)柚油(𠶢𩭶)牰由秞笛粙紬胄(䅢䊘䶇𦂈)舳苖蚰袖褏軸轴迪(䨤)邮釉鈾铀頔駎鮋鲉鼬𠱋𢂎𤉓𤉕𬱖
甲	㕅㘡㳌䆘䖖䖬䘥䛅匣呷岬庘押柙炠狎玾甲笚翈胛舺鉀钾閘闸魻鴨鸭𡊠𢘉
申	䡛䰠伸(敒)呻妽抻朄柛氠珅申眒砷神(榊)紳绅胂訷迧鉮𧊋𬬹
审	㻘婶审渖谉
电	电電
男	㽖侽娚男莮𠲸
甹	䀻䛣䳙俜娉梬涄甹聘騁骋𠁔𡞲𢓳𥺒𩩍
甾	㓯㿳䅔䎩䐉䣎崰椔淄湽甾緇缁菑輜辎錙锱鯔鲻鶅
畀	淠畀痹睤箅綥
畁	畁腗
畏	㙗㛱㞇㟪㱬㾯䋿偎喂(𣾿)嵔愄揋椳渨煨猥畏碨腲葨鍡隈餵鰃鳂𡀧𣉍
畐	㽬䈏䋹䌿䮠䵗偪冨(䒄)副(㨽)匐(蔔𨄑)堛富(䒇䔰)幅愊揊楅湢煏畐疈福(䕐)稫腷葍蝠褔諨踾輻辐逼鍢鰏鲾鶝𠸢
留	㨨(籀)䝀䶉塯媹嵧廇榴(籕𡂆)溜熘瑠畄留瘤磂罶蒥蹓遛鎦镏霤(㽌)飀飗餾馏騮骝鬸鰡鶹鹠𠺕𤄍𨢇𨻧
畱	㙧㩅(籒)橊澑璢畱癅羀鐂驑
畜	㗜㜅䙒傗慉搐槒滀畜稸蓄鄐𧏷𨃕
畝	畝畞
亩	亩
畟	㮨㹄溭畟禝稷謖谡
畢	㓖㪤㮿㻫䟆䬛嗶彃滭熚畢篳縪蓽(罼)蹕鏎鞸韠饆驆魓鷝𠌫𢳂
毕	哔毕筚荜跸
番	㢖㸋㺕㽃䆺䉒䊩䪛䪤䮳僠勫噃墦嬏嶓幡憣播(𡃓)旛橎潘(籓藩)燔(䕰)璠番皤磻繙羳翻膰蕃蟠襎譒蹯轓鄱鐇飜鱕鷭𤗹𫔍𬸪
畫	㗲㦎㩇䐸劃嫿澅畫繣
画	㓰婳画𠵾
異	㔴䔬廙潩熼異禩穓翼(㢞瀷)趩霬
當	㜭㼕㽆儅劏噹壋擋檔澢璫當礑簹艡蟷襠譡鐺闣𨆉
当	㓥垱当挡档珰筜裆铛𥹥𫟰
畺	㩖㹔䗵䲔僵壃彊(䕬)橿殭畕畺疅疆礓繮缰薑韁麠𪇏
畾	㔣㙼㵽㿔䉪䴎儡攂櫐(蘽)櫑瓃畾礧礨罍藟蠝讄轠鑘鸓鼺𡚗𦌵𨯔
壘	㒦㠥壘壨灅蘲鑸
疊	㜼㩸㩹㲲䴑曡氎疊
叠	叠𢶣𣜖
疋	㽰㿿䝪疋疎(䔫𠽔𢵽)
疏	㧧梳疏蔬
疌	㫸䑖䝊倢啑婕寁崨徢捷(蓵𠽕)疀疌睫箑緁脻萐蜨誱踕𣶏
疐	䡹䶑嚏嚔懥疐
疑	㘈㠜㽈䰯儗凝寲嶷(𦢾)懝擬疑癡礙籎薿觺譺𢥷𣝅𤾰𩼨
疒	疒
疾	㑵嫉愱槉疾蒺螏
癶	癶
癸	䙆䠏䤆䳫戣揆暌楑湀猤癸睽(藈)聧葵(𨆠𪆴)鄈鍨闋阕騤骙𡎝
癹	癹
发	䥽发废拨泼袯酦𦫘
登	㔁㡠㲪㽅䆸(㡧𢹑)䔲(𡃻𡦮𤃥𨯷)䙞䮴䳾僜凳(櫈)噔墱嬁嶝憕撜橙澄燈璒登瞪磴竳簦膯覴證蹬邆鄧(䠬𡂱𡓂𢸞𣞽𧔛)鐙镫隥霯鼟𤢈𤼸𧃵𨐸
豋	豋𤮘
邓	邓
發	㔇㗶䚨墢廢(䉬䕠櫠)彂撥橃潑癈發蕟襏蹳醱鏺驋鱍𧬋
発	㾱廃溌発醗𫝼
白	㕷㼟㿟䄸䎅䞟䳆伯(𦀪)劰岶帕帛(淿艊)廹怕拍(啪)敀柏(湐)泊(箔萡)狛珀白砶碧(𧓮)粕絈胉舶苩袙貃迫鉑铂魄(𡳺𥶱)鮊鲌𤇢𤽗
百	㓦㹮㼣佰咟帞栢洦百皕(䔤)絔蛨袹貊銆陌𡋦𢫦𧻙𨒹
皀	梎皀簋(孂)鵖
𣪘	匓廄廏廐𣪘
皃	㹸䡚皃
貌	㦝䫉藐貌邈
皆	㾬䃈䡡偕勓喈堦媘揩楷湝煯瑎皆稭蒈蝔諧(𢹆)谐鍇锴階鶛龤𥏪𥟠
皇	㾮䄓䅣䊗䑟䞹䬖䳨偟凰喤堭媓崲徨惶揘楻湟煌瑝皇皝篁艎葟蝗諻遑鍠锽隍韹餭騜鰉鳇𤾗
皋	㟸㤒㿁䔌䚌䜂䜰䣗䫧(𤅡)嗥暞暤槔滜獆皋皞翱韟鷎𬍂
臯	䝥嘷曍橰獋皥翺臯鷱𥢐𥴚(𣠘)
皐	噑暭槹獔皐皡翶
睾	䆁睾
皮	㓟㝿㢰㱟䏢佊坡(𠶊𣔡𤊫𤷵)岥帔彼(𠶎𡮌𢜢𢯏𣔓𣷭𥓳𦋕)怶披(𠵿𣈓)旇柀狓玻疲皮破(㗞)秛簸紴翍耚被詖诐貱跛鈹铍陂(𤚆)鞁頗(櫇𠠉𡂄)颇駊骳髲鮍𠱀𣃣𣃤𤿤𥹖𦨭
皿	皿𠰘𠱄
盈	㨕㵬䋼楹溋盈萾𡎠𡟚𡺦𤔷𥈱𨜏𨩙
益	㜋㱲䅬嗌塧搤榏溢獈益縊缢膉艗螠蠲謚谥貖賹鎰镒隘鷁鹢齸𡒪
盍	㔩㕎䐦䗘䫦嗑圔廅搕榼溘熆盍瞌磕篕豔(灎灩艷)醘鎑闔阖饁馌鰪𡏖𤸱
蓋	㯼䡷壒濭瓂礚蓋鑉饚𡣨
盇	盇葢豓
[去]	㹤㾀䖔䵽怯(𢯖𨨤)砝鉣
劫	㤼䀷䂲䂶劫蜐𠄳𠲵𡝔𢬱𦀖
刼	㥘刧刼𡮊
盖	㦈盖𡡇
艳	滟艳
盜	盜𣛯
盗	盗
盡	㯸儘嚍壗嬧濜燼璶盡藎賮贐
尽	䝲侭尽浕烬荩赆𡋤𧋅
監	㔋㜮㩜㯺㲯㺝㽉䆾䰐儖嚂壏尷懢擥檻(𡅋)濫(蘫𠑈)爁璼監礛糮繿艦襤譼轞鑑鑒鹽(䀋)𥌈𦡶𩁱
藍	㘕灆礷藍𣠩𤓆𤼓𥍍𧕭
籃	籃𣡓
[⿰〢⿱𠂉丶]	㧛鉴
监	㨫䍀尴槛滥监褴𨃎𨡼
蓝	蓝𣞎
篮	篮
览	揽榄缆览𬒗
覽	囕攬欖灠爦纜覽𡔑𥍖𥗽𧖐𨈇𨰲
覧	㰖䌫覧鑬𨇣
兰	㳕兰拦栏烂
盥	盥
盧	㠠㪭㱺㿖䰕嚧壚廬攎曥櫨瀘爐獹瓐盧矑籚纑罏臚艫蘆蠦轤鑪顱驢髗鱸鸕黸𠫂𢥈𨏧𩆴
卢	䡎卢垆庐栌泸炉胪舻芦轳鈩颅驴鲈鸬𠰷𢗼𢫘𣆐𨋤𬬻
目	㾇目瞐苜鉬钼
咱	㑑咱
直	㥀㨁䐈值嗭埴徝(憄)惪植殖淔犆直禃稙置(㯰)𠶗𡸜𡸽𤊧
𢛳	㯖德𢛳
相	㜀厢廂想湘相箱緗缃葙𢪷
霜	䌮孀灀礵霜驦骦鸘鹴𢹩
盾	㡒䋸䙉䛻䞺偱循(㵌𧝩)揗楯盾碷腯踲輴遁(𡀷𡮽𢶿𣜲𨮐)鍎鶞
省	㗂㨘㮐㼳㾪䚇偗渻省箵𨩠
眉	䰨堳媚(䉋)嵋楣湄(𩅹)煝猸瑂眉睂睸篃葿蝞郿鎇镅鶥鹛𠋥𡮠𣎊𥻡𩄎𩹪
看	看𠸦
眔	䳴眔遝(䜚嚃)
真	㒹㣀㥲䈯䐜(𠆍)䡩傎厧嗔填嫃寘嵮慎搷槙滇瑱瘨真瞋磌禛稹窴縝缜蒖衠謓蹎鎮(𤄱)镇闐阗顛(巔攧癲𪓇)颠(巅癫)鬒鷏黰齻𢅬𤛇𤠶𧜖𩝻
眞	塡愼槇眞鎭顚(巓)鷆𡻗
衆	䝦潨衆𢶢𨙛
眾	潀眾𤎏
睘	䁵䚪䴉䴋儇噮圜(攌)嬛寰彋懁擐檈澴獧環癏睘禤糫繯缳翾蠉譞轘還(㶎𡄤)鐶镮闤阛鬟鱞鹮𫍽
[不2]	环还(𡮗𭈮)
睪	㘁䁺䆁䐾䕉䦴䭞凙圛墿嬕嶧懌擇(籜)斁曎檡歝殬澤(䕪蘀)燡睪礋繹蠌襗譯醳釋(𨰪)鐸驛(㶠)鸅𩍜
[⿱又⿻丨二]	峄怿择(箨萚)泽绎译释铎驿
睿	䜜䞊䥧叡壡濬璿睿龼𤀹
[⿳艹罒儿]	䉚䠢甍薨蘉
夢	㙹㝱䑅䙦儚夢懜鄸顭𡗐𤔻𤘂𥶃𨮒𩆠
瞢	㜴䒐䲛懵瞢矒
梦	梦
瞿	㘗㜹㩴㬬䂂匷忂懼戵欋氍灈爠癯瞿臞蠷衢(𡆚)躣鑺鸜𡚝𨟠
矍	䂄䢲䣤䦆彏戄攫欔玃矍矡籰蠼貜躩钁(𧟝)𧮞
矛	䖥䟥柕楙(懋)矛罞茅(鶜)蟊袤雺髳𢘅𨥨
矞	䆷䤎䰬僪劀噊憰橘潏燏獝璚(𩽗)瞲矞繘譎谲蹫遹鐍霱驈鱊鷸鹬𢵮𧑐𫔎
矢	䀢䂠䐅䒨䛈垁矢笶鉃鴙𥎵𥏍
雉	䉜薙雉𢶾
稚	䕌稚𥣽𥴢
矣	㶼㸻䀵俟唉埃(𣘂𤠱)娭挨欸涘矣竢誒诶逘騃
知	㲛䓡䝷䣽䵹倁椥痴知蜘踟鼅𢜔𢯙𣊋𥯌𩸴
智	䚐䠦智潪𡡧𥋒𧒊
石	㸴䂞䄷䖨䞠䲽坧庹拓斫柘沰炻石硕碩磔磭祏袥跖鉐鼫𠰴
妬	妬𠊜𣔧𥯉𦲼
妒	妒
砉	剨湱砉騞𬴃
磊	㔏㩡㰁磊藞𠁻𠐞𡂳𡓃𡤟𢤡𤂬𤑭𤢿𤻳𥫌𥶲𦇒𨇒𩟬𩧍𩯹𩽊𪒽
𥐧	𠶡𡍟𣷮𤊠𥇼𥐧𥓹𩸷
示	䱈呩沶狋眎示祁視视
礼	礼𠲥𡋀𢙔𢬦𣉷𣑶𥘶𥘷𥙒𥙓𥙧𥙩𥙪𥚄𥚇𥚥𥚯𥛉𥛭𥜤𦮲𧜐
祘	祘蒜
祝	呪咒柷祝𠺷𡎺𣘌𤹙𨃷
祟	㱁䳳祟
[⿰祟又]	㝮䔴
贅	嚽贅
赘	赘
票	㟽㬓㼼䅺䏇䴩一僄剽(㠒檦)勡嘌墂嫖幖彯慓摽旚標漂(薸𡁼𨆺𨮶)熛瓢(䕯𤃛)瘭瞟磦票篻(𣠓)縹缥翲膘蔈螵褾謤醥鏢镖顠飃飄(𤅜𦣕)飘驃骠魒鰾鳔𧴋[⿰票寸](㯹㵱)
标	标
祭	㗫㡜䏅傺憏摖暩漈瘵磜祭穄縩詧際鰶𨄊𬶭
察	䃰䕓嚓察擦檫聺鑔镲𥌀𨆾𩟔
际	际
禁	㦗㩒㯲㱈䌝䫴僸凚噤澿禁襟(𡅢)齽𡑲𣋜𣰙𤻎𥋴𥽍𦡞𦽔𨣤𨭺𪇎𪊅
禸	禸
禹	㙑㙖㝢䄔䨞偊楀渪瑀禹竬聥萭蝺踽鄅齲龋𡟥
禺	㥥㬂㷒㼴䚤䦸偶(𠽀𢠉𣼱)喁堣媀寓(䴁𠿄𣛡)嵎庽愚(㦙𦽳)歶湡(蕅)禑禺耦(藕𡂮)腢遇鍝隅(𣿃)顒(𡅑𡿅𥍎)颙髃鰅齵𡺥(𢢄)𤸒𨲖
离	㷰䄜䅻䍠䬜摛樆漓璃瞝离篱縭缡蓠螭褵謧醨魑麶黐𠻗
離	㒧㒿㰚䍦䙰囄攡灕籬蘺離
禼	禼竊
禽	噙擒檎禽蠄𢢬𣍗𤢌𥋼𦡬𨆓
禾	䒩姀柇盉禾訸鉌龢𥞩
和	俰咊和啝惒萂𣷓
禿	䛢痜禿秃鋵鵚𥟉
秀	䅎䞬唀琇秀綉绣莠(璓)蜏誘(𡁹)诱透銹锈𢭆𣒴𣵛𥤃
秉	㨀棅秉𠶏𥡝
秋	㡑㾭䋺䎿䐐䨂䵸偢啾媝愀揪揫楸湫湬煍甃瞅秋秌篍萩蝵踿醔鍫鍬锹鞦鬏鰍鳅鶖鹙𩹤
愁	㵞僽愁矁𠿈𣜷
科	䈖䌀犐科萪蝌
秝	䔉秝
秦	嗪嫀搸榛殝溱獉瑧秦縥臻(㰉)蓁螓轃𡻈
𠂔	㾅䙻姊柹泲秭笫胏趀𠂔
㣎	㣎穆
穌	㢝櫯穌蘇(囌𡚡𥗹)𡚢𢀱
稣	稣
酥	酥
苏	苏
穴	㧒䋉䛎䴳坹岤泬穴茓袕鴥鴪𠱇
穹	䛪䠻焪穹𠶥
空	㲁㸜㾤䅝䆪倥啌埪崆悾控椌涳焢硿空箜羫腔(𨭏𨭒)谾躻鞚鵼𣈞𦁈𧌆
穿	瑏穿𥈹
突	㟮㷝㻠䃐堗揬湥突葖鶟鼵𠸂𣔻𥈳𥯝𦂽𦝬𦢴𧎛𨃍
宊	宊涋
竄	攛竄躥鑹
窜	撺窜蹿镩
立	㕇㕸㡴㱞䏠䢂䬃䲞䶘垃岦(𥺺)柆砬立笠(鷑𡓆𣙫𥼕𩻒)粒(𨅀𩻑)翋苙趇鉝雴颯飒鴗𠙅𢘮𤇥𤖹𥅈𥩰𨀎𨅁𨋢𨚪𩶘𫟷
拉	啦拉菈鞡鿜
泣	泣湆𢯛𦲷𨂖
竟	䔔䭗傹境摬樈滰獍璄竟竸糡鏡镜𡙴
章	㢓傽墇嫜嶂幛彰慞暲樟漳獐璋瘴瞕章蔁蟑遧鄣鏱障騿鱆麞𢕔𩕆
童	㠉㼿䂌䃥䆹䚒䝑䡴䭚䮵䴀僮勭噇墥幢徸憧撞曈朣橦氃潼燑犝獞疃瞳穜童罿膧艟蕫(𢤦)蹱鐘𡈩𦒍𧑆
竞	㜔竞
競	競
誩	誩
竹	䈞竹竺笃筑(篫𣽆){茿}築篒篤(𡄍𡓞𡾬𤒘𥽪𧞶𨯹𩟵𩠸𩽖)
笑	㗛笑𡮜
筆	㻶潷筆𡼸𤏫𤔯𤢇𤺭
笔	滗笔
等	㩐等𠎬𥪸𦅯𨅸
筋	䈥筋
筮	㭀噬澨筮簭遾
算	㔍(䥷)䉵䵵匴算篡篹籑纂(攥)𨰉
節	㘉㦢㸅䗻䲙幯擳櫛瀄癤節蠞𠠑𨙌
节	栉疖节
米	㝥㪰䋛䍘䱊侎冞咪敉洣眯(蔝)米脒詸銤麊麋(攗蘪)𠩕𢘻
迷	㜆㴹瞇蒾謎谜迷醚𡗅𣗌𥷻𦟂𩄲
粟	㔄䌚䥔僳憟潥粟𤢂
粥	粥鬻
粦	㔂䗲䚏䫰亃僯噒嫾嶙憐撛暽橉潾燐獜璘甐疄瞵磷粦粼繗翷膦蹸轔辚遴鄰(𡂰𡓏𢸜)鏻隣驎鱗鳞麟𡑝𢕸𥻘𨊌𬭸𬴊
㷠	㷠䮼
粲	㣓儏殩澯燦璨粲薒𢷂
[⿰歺又]	㛑䝳䱗餐(爘)
[粵]	澚
粤	粤
粵	粵𠟲𧞄
糞	䆏瀵糞
粪	粪
糸	糸
系	係(喺𦵠)系
素	㨞䛾傃嗉塐嫊愫榡溸素縤膆螦𤍊𤠚𥱨𩘣
索	㮦䅴䌇䖛䞽嗦溹索鎍𢱢𥻨𩌈
累	㹎䉂䐯傫嫘摞樏漯瘰磥累縲缧蔂螺鏍镙騾(𩇍)骡𠼱𤍶𦧲
纍	㶟儽欙癳纍纝虆
絕	㔃㔢撧絕蕝𠾼𣾵
绝	绝
[⿱刀巴]	栬絶脃脆𡜆
絲	噝絲蕬鷥
丝	丝咝鸶
緐	㶗䋣緐
綿	㒙嬵檰矊綿緜𢅧𥽔𧓭
绵	绵
[帛]	䃇䛲棉
縣	懸縣
县	县悬
繁	㩯瀪瀿繁蘩
繭	繭襺
茧	茧
缶	㓡㯱寚珤缶缹缻
寶	䴐寶靌𢺔𨰦
宝	宝
网	䋞䒽䰣网蛧𦬣
罔	䃃䱩惘棢焹網罔菵蝄誷輞辋魍龬𣶈
罙	㤾探(𠽄)棎深(𠽉𡪜𪒗)琛罙賝𠶀𧨾
穼	㴱穼
罪	㠑䊫嶵檌罪
罰	罰藅
罚	罚
署	曙濖糬署薯(蠴)鱰𠏲𣞍
罷	㔥䆉䎱䥯擺犤矲罷羆藣襬𠤩𡓁𡳹𢤛𣞻𤳷𤳸𨇑
罢	䎬䙓摆罢罴𠙣𡌣𢅄𣉳𣘓𣡯𣺽𤳄𦃿𩺩
羅	㦬㼈㿚儸囉攞曪欏玀籮(囖)纙羅蘿邏(𡆗)鑼饠鿡𠚢𡤢𤓓𤴏𦍉𦣇𦲿(𡄀)𧟌
罗	㑩啰椤猡箩罗萝逻锣
羈	羈覊
羁	羁
羊	㟄䍩䬺佯劷咩垟庠徉样氧洋烊珜痒眻祥(㬕䔗)絴羊羏羘翔蛘詳详鴹𥒞𦭵
養	㔦䑆䭥懩攁瀁癢礢養鮝鯗鱶鲞𡒶
养	养
羕	㨾樣漾羕𠍵𠓁𡡂𤎔𨄶
恙	㺊䭐恙
姜	姜葁𦎛
羌	㛨㳾唴猐羌蜣錓𠊡𠻁
羋	羋芈蝆
羍	羍
達	㒓㣵㺚㼀㿹䃮噠墶撻(𡃿𤃧)橽澾燵繨薘蟽躂逹達鐽闥韃𡐿𦡯𧞅
美	䓺媄嵄渼美鎂镁𠝫𠸍𡎤𡮔𢱒𣖙𥈢𥖺𥻙𦝺𨷑𨸈
羑	㕗湵羑
羔	㚠㟱䅵䫞榚溔禚窯糕羔蓔餻
窑	窑
義	㕒㠖㩘㬢㼁䉝䕏䣡䧧䰮䲑䴊儀嬟嶬檥燨犠礒羛義艤蟻議轙鸃𠿿𡃛𡅷𢣂𥋟
羲	㙿㰕䂀曦爔犧羲𡾞
义	义仪舣蚁议𭩚
羸	㬯㱻䇔䊨䌱䌴䯁羸臝蠃驘鸁𤅀
羹	羹
羽	䣁䦀䨒栩珝祤羽翵蛡詡诩頨𦭳
翁	㨣㮬㺋䈵䐥䩺䱵傟勜嗡塕嵡慃暡滃瞈翁聬蓊螉鎓鶲鹟𤹗𬭩
翌	翊翌蛡
翏	㬔㺒䚧䢧䰘䵏僇剹勠嘐嫪寥(㵳)嵺廖(𦆲)憀戮摎樛漻(䀊)熮璆疁瘳磟穋繆缪翏膠(㶀廫)蓼蟉謬谬豂賿蹘轇鄝醪鏐镠雡顟飂髎鷚鹨𪤗
習	㗩㠄㦻㿇䌌䐲䒁嶍慴摺槢漝熠磖習褶謵霫飁騽鰼鳛𡏽𦒉
习	习
翕	㒆㩉㬛㯓㽂䁯噏嬆嶖歙潝熻翕翖蹹闟
翟	㒛㪬㺟㿑䊮䌦䢰䴞嚁嬥戳擢曜櫂濯(𥷧)燿矅籊(𢺜)糴糶翟耀(𤓛)藋蠗趯躍鑃鸐𥣞
翠	䕜噿濢璻翠臎
翆	翆
老	㐗㖈㧯㳣䇭䳓佬咾姥峔恅栳狫硓粩老荖蛯銠铑𦒵𦒹𦕳𧻩𨀼
考	㘼㼥拷栲洘烤考耉銬铐鮳鲓𠱼𣑥
者	㗯㥩㨋㸙䎞䐗䘄䡤䬡䰇䰩䵭乽偖啫(𣾻)堵(𧹻)媎屠帾斱暏楮渚(𠤆𠹲𡤊𡪦𢵻𣜾𤁛𥢳𦼥𧸓𩅻)煑煮(㵭)琽瘏睹箸(櫡)緒緖绪翥者褚覩(𣠶𤒠𧺂𧺃𨇛𨇜)觰賭赌赭踷醏鍺锗闍阇陼𠁂𣂃𣗓𤂩𤌄𦩳𨔾
奢	㦋㵔奢奲撦譇𠾏𨶶
耆	䅲嗜愭搘榰耆蓍螧鬐鰭鳍
而	㖇㧫㾍䎟䎠䛔䫱䰭侕峏恧栭洏糥而耏耐聏胹荋袻輀陑髵鮞鲕鴯鸸𡭺
耎	㐡㓴㨎㬉㮕㼲㿵䓴䙇䞂偄堧媆愞渜煗瑌碝稬緛耎腝蝡輭陾餪
耑	㙐㟨㪜㼷䝎䳪䵎偳剬喘圌媏惴揣椯歂湍煓猯瑞端篅耑腨褍諯貒踹輲遄鍴顓颛𧍒
耒	㑍㼍䋘䒹䛶䣂洡筙耒誄诔銇頛𠓩𠱤𡋃𡥤𢙩𢬗𣑳𤈞𤞖𥅦𥑶𥹯𧋆𨀤
耳	㛅䋙䌺䎶䏪䣵佴刵咡恥(𠺨)栮毦洱珥眲耳耻聻衈誀鉺铒餌饵駬髶鵈𣭞𥚅𨌀𨏄
耴	㑙㡇㤴㭯㳧䎎䳖耴聑踂輒辄銸鮿
耶	㖿倻揶椰爺瑘耶鎁𦳃
爷	爷
耷	㿴䐛耷𠸊𡍲𢱕
耿	耿褧
聽	廳(𣡹)聽
聖	檉聖蟶
聚	㔌㵵䝒䠫聚藂鄹驟骤𧓏𨽁
[⿱⿰幺幺丱]	關
聯	㶌㺦壣聨聮聯
关	关联関
聶	㒤㱌㸎䌰䝕䯀囁懾攝(𥸓)欇灄聶襵讘躡鑷顳𡆄𡓳𣀳
聂	䯅嗫慑摄滠聂蹑镊颞
聿	㖀㡽䋖䢖䮇侓冿垏峍律(嵂箻葎𠷈𢖀𣹕𦂻)硉聿肁茟銉𢫫𣑵𤈠𦛌𧊐𧙻𨀞
肅	㔅㩋㪩㬘䃤䊥䎘䐹嘯彇橚歗潚熽璛簫(𤄙)繍繡肅蕭(櫹瀟蠨𤑳𦢩)蟰鏽驌鱐鷫
肃	㴋啸箫肃萧(潇蟏)骕鹔
粛	䔥嘨簘粛
肇	肁肇肈
肉	䐓䶺朒肉脜𠒯
肯	啃掯肯褃錹𣔨𥺾𬒔
肖	㲖㲵䇌䏴䘯䨭䴛俏削(䌃揱箾萷鞩𠸑𦂗)哨(𪄨)娋宵峭(㴥)帩弰悄捎(䈰)旓梢(䈾䔠)消焇痟睄矟硝稍(潲蕱𠿀𥳓)筲(𠿫𢶠𥋘)綃绡肖艄莦蛸誚诮趙(𡁻)踃輎逍銷销陗霄鞘韒颵髾魈鮹𪁎
赵	赵
[寸]	䖞疛紂(䈙葤)纣(荮)肘討讨酎
肙	㘣㾓䅌䣺䧎䬼剈埍娟弲悁捐梋涓(𠅻)焆狷琄瓹睊絹(㯞羂)绢罥肙蜎裐鋗鞙駽鵑鹃𫓶𫦪
䏍	㳙㻆䏍䳌姢
肩	䑷掮猏肩菺顅鵳
肰	肰
育	㛩㥔䋭䘻俼唷堉棛毓淯焴育艈蘛蜟逳錥𢯡𣨧𤟂𦱀𨂔𨌯
肴	㮁倄崤殽淆肴誵郩餚𠴳
胃	㙕㥜䁌䬑喟媦彙彚渭煟猬稩緭胃蝟謂谓𢯮𣖜
背	㔨䋳偝揹背褙鄁
胡	㗅㾰䠒䩴䭌媩楜湖煳猢瑚箶糊胡葫蝴衚醐鍸餬鬍鰗鶘鶦鹕𧛞
胤	湚胤酳𠸕𧎠
胥	㥠䈝䱬偦壻婿揟楈湑稰糈縃胥蝑諝谞醑𤟠𧩑
能	㑷㨢䘅態熋能螚褦𠹌𢟒𨶙
脅	㙝嗋愶搚熁脅脇
胁	胁
脊	塉嵴瘠脊膌蹐鶺鹡
膚	膚
臣	䛗䢻嚚挋臣茞頣
臤	㹂䁂䵖堅(䃘䌑䵛慳摼樫熞鏗鰹𡐖𥉸𦸃𪅤)婜掔硻緊(𡁵𦤱)腎臤菣蜸賢(㘋䉯礥臔藖鑦𡮷𡮺𢤞)贒鋻
[⿰〢又]	䝨(𠍦)坚(㭴悭铿鲣)紧肾贤
臥	卧臥
臦	煛燛臦臩
臧	㵴臧贓
蔵	臓蔵
藏	㶓欌臟藏贜鑶
臨	瀶臨𡄦
临	临
自	垍洎自臮詯郋𡜍
臬	㓷㙞㴪寱嵲甈臬臲鎳镍闑𫔶
臭	㱗䠗嗅搝殠溴糗臭螑齅𡏣𨻬
臱	㝰䟍䡻䫵䰓櫋矏臱邊(籩)
边	笾边𤶒
至	䇪䘭䬹䶍侄咥垤姪峌庢恎挃晊桎(𣉴)洷痓眰祬秷窒(㗧䏄潌膣螲)絰绖耋胵至荎蛭跮輊轾郅銍铚駤鵄𤈜(𩺧)𩒐𩶪
致	㨖㮹㴛䞃䦯緻致𠊷𡍶𦳙
臺	㘆儓嬯懛擡檯籉臺薹𤢬
㙜	㙜㙵㸀
䑓	㒗䑓
臼	䊆䳎䳔桕臼舅(𡀭)舊(匶欍)齨
旧	旧𡳵𡳶𦼨
臽	㡊㷺䐄䘓䧟䱤䶟啗埳惂掐欿淊焰(𡓢𧀜)燄窞(𢶺𣛱𥋺)臽萏蜭諂谄輡錎陷(𠽏𢶽𥊥𨄽)餡馅鵮鹐𥛗
臾	㔱㥚㳛庾惥斔斞楰瘐腴臾萸諛谀
臿	㛼㞚㢎㮑㰱㴙䅤䙄䛽䮢偛喢挿插(𠿂)敮歃牐臿鍤锸𣖄𤊿𤿪𥀈𦝥
舀	䈱䤾䵚塪嫍幍慆搯槄滔(𨭡)瑫稻縚舀謟蹈轁鞱韜韬饀𥉰𩥅
舁	舁
舂	㦼䄝䚎憃摏樁舂蹖𠽅𢠅
舄	㕐(㵼)䉣寫(䥱瀉(𡄽)藛)潟澙獡磶舄蕮
写	䥾写泻
與	㒜㠘㦛㵰㺞䑂嬩嶼懙擧(㩮欅)旟(㶛)歟璵礖礜穥籅舆與藇譽輿轝鱮鸒𠁹𡁎𡒊𢷣𤑉
舉	㐦攑櫸舉襷𡤒𤰁𨷯𨷶
[兴]	誉
举	举榉𫽥
挙	挙﨔
興	䕟嬹臖興
兴	兴
舌	䏦䞌憩絬舌𧵳
舍	倽啥捨涻猞舍舒騇鵨𨛭
舛	舛荈
舜	䢬䴄僢橓瞬舜蕣
舟	㭧䎇侜洀烐珘矪舟貈輈辀郍鵃鸼
般	㮽䃑䈲䰉媻幋搫搬槃瘢盤(䃲䰔瀊𡂑)磐縏般蒰螌褩鎜鞶𩺪
盘	盘
艮	㡾㸧䦘䫀䬶哏垠垦峎很(䓳)恨恳拫根(𦶠)泿狠珢痕眼(𠽗𡙵𣙧𣼹𨢻)硍艮艰艱茛蛝裉詪豤貇(墾懇(𡄩)𠿵𢢽)跟銀(檭𪇩)银限(䈨)鞎齦龈𠦯𥐇𥐉𬣳
良	㝗㟍㢃㫰㱢㾗䀶䆡䍚䡙䯖俍剆勆哴埌娘崀悢斏朖桹欴浪(蒗𠺘𡻔𨃹)烺狼(𦵧)琅硠稂筤粮艆良莨蜋誏踉躴酿鋃锒閬(䕞)阆駺鿶𢭗𧚅𩷕
朗	㙟㮾塱朗樃蓢𠓇𠻴𡂯𢀬𢠯𣼽𤅉𤎜𤨡𦄺𨅉𩅜𩡜
郎	㾿䱶啷嫏廊榔瑯蓈螂郎鎯鿥𢀨𢲲𦗏𨄂𨖅
色	色赩銫铯𪁅
艸	艸
芻	㑳㗙㥮㮲㱀䅳䐢䑼䪮媰搊煼犓皺篘縐芻蒭(𡁿)謅趨(𢹤)鄒雛騶鶵齺𡙦𡦅𣉵𧎷𨎆𩺥𪄞
刍	㑇㛀㤘䋓刍皱绉诌趋邹雏驺
苗	㑤䅦喵媌庿描渵猫瞄緢苗貓錨锚鶓鹋𦏒
若	䖃䤀偌喏婼惹(㘃)掿楉渃(𢢉)睰箬若蠚諾诺蹃逽鄀鍩锘鰙𢜪
英	㡕㢍㲟䁐䊔䚆䣐䦫䭊偀媖愥暎朠楧渶煐瑛碤緓绬英蝧鍈锳霙韺鶧鿦𠸄𡎘
茍	茍
茸	㲨䠜䤊䩸傇媶搑榵穁縙茸
䇯	䇯
茻	茻
荅	㜓㟷䌋剳匒嗒塔搭榙溚瘩荅褡鎝鞳𥉌𦖿𨱏
答	㗳㙮㯚㲮劄撘答譗𤏧𤺥𥰊𨅞
莫	㱳㵹㷬䮬募嗼塻墓嫫寞幕(冪濗)幙慔慕摸摹(𤑮)暮暯模(𡃗𤂨𥀳)氁漠獏瘼瞙糢縸羃膜莫蓦蟆蟇謨(𢺀𥷺𧄲𩇅)謩谟貘鄚鏌镆饃馍驀鬕𢨃𧷸
莽	㟿㬒䁳䒎䥈漭莽蟒蠎𠻵𢳠𣙷𥕊
菐	㲫㹒䑑䗱䧤䪁䴆僕(㙸㯷濮纀襥𡂈𨆯)噗墣幞撲(𡃒𤾷𦢟)樸(𡃾)獛璞瞨穙菐襆贌蹼轐醭鏷镤𣾴𦄾
華	㠏㦊䅿䔢嘩嬅崋撶樺澕華譁鏵鞾韡驊鷨𦠜
华	㟆华哗桦铧骅
萈	萈
寬	寬臗鑧髖𡂷𣟂𦪻
宽	宽髋
萬	䘍䜕勱噧澫燤癘萬蠆(囆爡)蠇贎邁𢶯𣜜𤢥𦽳𨆣𨭬
著	㒂䦃墸擆著躇鐯𤀞𤏸𤻔
着	撯着𤏲
葬	塟葬髒
蒐	蒐
蒙	㠓㩚䑃䙩䤓䰒䴌䵆幪懞曚朦檬氋濛獴(𧃶)矇礞艨蒙蠓靀饛鸏鹲𠖨𡁏𡒯𡮹𤔽𤔾𤘁𤮠𥵿𦆟𧅭𨮵
蒦	㠛㦜㬦䕶䨥䨼䪝劐嚄嬳彟彠擭(䉟)檴濩獲瓁矆矱穫籆耯臒艧蒦蠖護鑊(𡆇)镬雘韄頀鱯鳠鸌鹱𧞤
获	获
蔑	㒝㩢䁾䌩䘊䩏䯦幭懱櫗瀎礣篾蔑薎蠛衊襪鑖韈韤鱴𡃙𣋻𤻻𩆪𪇴
蔡	䌨攃櫒礤蔡
薦	䍎瀳薦韉
虍	虍虡(簴)
雐	雐
虎	䗂䝞䰧俿唬椃淲琥箎萀虎諕錿鯱𢜜𧇍
虧	虧𢣧𣌉𧃷𩆾
虐	㖸瘧虐謔谑𥈴𦞐
疟	疟
虒	㔸㡗㥴㴲㾷䖙䚦䞾䫢䴘䶵傂嗁搋榹歋(擨)磃禠篪虒螔褫謕蹏遞鷈鷉鼶
虔	㓺㗔㨜䖍榩虔鰬𥱲𧤥𨪝
處	㨿處𠽁
䖏	㩀䖏
処	処拠
处	处
虖	㙤㦆㯉㻯嘑嫭摢歑滹罅(嚹)虖謼鏬(𡅈)
虘	㜘㢒㪥䁦䠡䣜䶥摣樝皻蔖虘覰謯齇𪓐
[虛]	㠊墟憈歔覷譃驉魖鱋𥲤𨼋[戱](㩬)
虛	噓戱虗虛
虚	嘘戯虚觑
虜	㢚㯭䲐擄艣虜鐪
虏	掳虏
虫	䂈䖝䳋痋虫蜼融(曧瀜)螎蟲赨鉵𣑺𧙽
虺	䖶虺豗
㕚	㕚
蚤	㲧慅搔溞瑵瘙糔蚤颾騷骚鰠鳋鼜𠋺𦃐
蚩	㺈䧝䩶嗤媸滍蚩𤠷
蜀	㒔㯮㻿䟉䪅䫳䮷劅噣擉斀斣斶歜濁(𢹅)燭獨(𤣡)臅薥蜀蠋襡觸躅(䕽)鐲镯韣髑鸀
[虫]	浊烛独触
蠱	蠱
蛊	蛊
血	䆝䒸䘏䦗侐卹恤桖欰殈洫(𠸡)烅血裇賉𠲣
行	㤚䀪䚘䯒䰢哘垳桁洐(䓷)烆珩筕絎绗胻荇行衡(蘅)裄鴴鵆鸻𣆯
衍	愆椼葕衍餰
衛	㦣衛讆躗𡓎
衞	衞讏躛
卫	卫
衣	㕈㛄㳖䒾䧇依(㥋𠵱𤷴𦲤)哀庡扆畩衣銥铱餏饻𠲖𣐿𥑴
表	㧼䁃䱪俵婊脿表裱諘錶𠶓𣍅𣷴𤷶𧶫𩤕𩩩
衰	㲤䙑榱滖簑縗缞蓑衰
袁	㝨㨬園(薗𡑰)媴榬溒猿瞏袁褤轅辕逺遠(薳)鎱
裔	㵝䕍裔
褭	㒟㜵㠡䃵褭𣟊
裊	䙚嬝裊𡀮𡑩𢶑𦆚
袅	袅
褱	㜳䃶壞(蘾)懷(蘹𡅬)櫰瀤瓌耲褱
襄	䉴䑋儴勷嚷壤孃忀懹攘曩(㶞𡔒𣌝𣎦𣡤𤓢𥘀𥸒𦣙𨤼𨰴𩟻)欀瀼爙獽瓖瓤禳穰纕蘘蠰襄讓躟釀(䖆)鑲镶饟驤骧鬤𬙋
囊	㚂儾囊囔攮欜灢饢馕𦣘
㐮	㐮壌嬢穣譲醸齉
襾	襾
西	䄽䇴価哂徆恓拪晒(嗮)栖毢氥洒(𢱛𦵜)牺硒粞絤舾茜西跴閪𡧳𢬣𤞏𤶈𨠴
要	㙘㫏㴗䁏䌁䙅䳩偠喓婹崾楆腰葽要闄騕𢞅𢰳
覃	㜤㽑䊤䐺䚓嘾墰憛撢曋橝潭(䨵藫)燂瞫磹禫簟(㶘)罈蕈蟫覃譚谭贉醰鐔镡驔鱏鷣𦅰𫣗
見	䅐䏹䙽䧋䨘䩤俔哯垷娊峴悓挸晛梘涀現(𠻷)睍硯筧粯絸莧蜆見覎視覤誢鋧靦麲𠄺𡫨𤶻𧢟𨁍
见	伣岘枧现砚笕舰苋蚬见觃𪾢𬀪
規	䲅嫢摫槻槼瞡窺規闚鬹
规	椝窥规鬶
覓	㯒䌐䮭漞覓覛𠼽
覔	覔𢴓𨅂
觅	觅
親	䞋儭嚫寴櫬瀙藽襯親𡤅
亲	亲媇新榇
角	䇶唃埆崅捔桷确角𩷛
解	㙰㿍䉏䲒嶰廨懈檞澥獬繲薢蟹蠏解邂𢶷𧞊
言	㢇䂴䇾䓂䴦唁圁娮狺琂言訔(𠻂𤍉)訚誾這(𥳅)𤉘𤯆
这	这
訇	揈渹訇輷鍧
設	蔎設
设	设
詹	㙴䃫䄡䟋䠨䦲䪜儋噡嶦幨憺擔曕檐澹甔癚瞻簷(𡅨)聸膽舚薝蟾襜詹譫谵贍赡韂黵𣠳
諸	㶆䃴䊰儲櫧藷蠩諸𠤌𣌆𣠖
诸	储槠诸
[⿱必皿]	㴵䤉榓謐谧
谷	㭲䀰䎥䘱俗(𠸘)唂峪欲(慾螸)浴焀裕谷輍鋊鵒鹆𠗖𣃺𣍂𥙿𧣳𪁴
豆	㐙㛒㜐㢄㤱㪷㰯䄈䇺䛠䜳䜴䱏侸剅哣梪毭浢痘短脰荳(𠻼)裋豆逗郖鋀頭(䕱)餖饾𢭃𨁋
竖	竖
豎	㷂竪(㒘)豎
头	头
豈	㨟㱯䁗䅱䐩䔇䠽䭓䱺䶣凒凱剴塏嵦愷敱敳暟榿溰獃(𠏥)皚磑螘覬豈鎧闓隑顗颽𠹛𤠲𩥉
岂	凯剀垲岂恺桤皑硙觊铠闿𫖮𬮿
呆	呆
豊	䌡䪆澧禮(𡅏𡓾𡤠𢹿𣠲𧕬)豊軆鄷醴體(𥸠)鱧鳢𧬹
体	体𥮋𧡊
豐	㒥㠦寷灃蘴豐酆靊麷
[豊]	䵄僼霻
豕	嶳豕
豖	㙇㞘㧻䐁䦠冢(塚)剢啄椓涿琢瘃硺諑诼豖𢽚𨧧
豙	豙顡
毅	䉨毅藙𡃀
豚	豚遯
象	䴂像勨嶑橡潒蟓襐象鐌鱌
豦	㯫㷾䆽䟊劇(㘌𥗌)勮噱壉懅據澽璩臄豦躆遽(籧蘧)醵鐻
豬	櫫瀦藸豬𣌁𣌂𣠕
猪	橥潴猪蕏𧒇
豸	絼豸𠉠𢚵𢭺𤉒𧼋𧼌
貝	㛝㸽䟺䢙䩀唄垻孭敗(贁𡏯)梖(𦹶)浿狽珼蛽貝鋇鵙𢭲𣇜𥺎𦁀𧸒𧸻𪔡
贝	呗坝狈贝败钡𬇙
貞	䡠偵媜寊幀揁楨湞碵禎緽貞赬遉鍞鼑𠸩𡎞𣦓𤦹𥢅𥢆𨜓𩹰
贞	侦帧桢浈祯贞赪𰌂
負	偩媍萯蝜負𢰺
负	㭥负
貢	䔈嗊幊愩慐摃槓熕碽篢貢贑𠗸𢩛𣹟𤗤𤳢𥈿𥨨𧜙𨫋𨶛𪄌
贡	䂵唝贡𬕂
貪	㵅僋嗿貪𦤰𦹳
贪	贪
貫	䗰慣摜樌瑻罆謴貫躀遦鏆𤎽𥖏𦄻
贯	惯掼贯
責	㣱㥽㱴㺓䚍䟄䥊䶦債勣嘖嫧幘樍歵漬皟瞔磧積(廭癪𧂐)簀績耫蔶襀謮責賾赜蹟鰿𦟜𧐐𪄸
责	债啧帻渍碛箦绩责赜𪟝𫌀
貴	㚍㿉䙡䜋䠿䫭䯣䰎僓嘳圚墤嬇尵憒撌樻殨潰璝瞶簣繢聵膭蕢貴蹪鐀闠隤(濻藬)靧鞼饋
匱	㙺䕚匱櫃籄鑎𢷴
遺	䑊䪋壝瀢讉遺𨯯
頹	㿗瀩穨蘈頹𣟩𦢶𧔾𨯸
頺	頺𠐬𡾫𢹉𤒟
贵	㱮䅪䙌䣒匮愦溃瞆篑缋聩蒉贵阓馈𬯎
遗	遗
颓	颓
買	㜥㵋䁲䚑嘪簤蕒買賣鷶𠃅(𡣧)𡤓𡤔𡮨𡮳𢵯𣛠𨊋𩴬
买	买卖荬
費	㩌㵒䊧曊費鄪鐨靅
费	费镄
賁	㱵㿎䒈䩿䴅僨噴(𡅊𤂫)墳幩憤橨歕濆燌獖羵翸膹蕡蟦豶賁轒鐼隫饙馩鱝黂
贲	偾喷愤豮贲鲼𣸣
賈	價檟賈𠿪
贾	槚贾
賊	蠈賊鱡
贼	贼
賏	䴍甖罌譻賏鑍鸎
[⿰贝贝]	罂
賓	㡦㯽䎙䚔䧬䨈儐嬪擯檳殯濱濵獱璸矉礗穦繽臏薲蠙賓賔鑌顮馪驞髕鬢𡒨𡣑
質	㜱㩫䑇䜠儨劕懫櫍瓆礩筫貭質躓鑕𡂒𡒻𡦫𤢽𧓳𨐿
质	质踬锧𬃊
賴	㸊䄤䠭䲚嬾懶攋櫴瀨瀬獺瓎癩籟藾襰賴𡃤𡚚𢀲𢁑𣡙𣡚𦧺
赖	懒濑獭癞籁赖
贊	㜺㦫䂎䡽䰖儹劗囋巑攢欑灒瓚礸禶穳籫纘臢襸讚贊趲躦酇鑽饡𢑊𤓎
賛	㠝㸇䟎儧攅櫕濽瓉纉讃(𥸝)賛鄼鑚𨘧
赞	攒瓒缵臜赞趱躜酂𪷽
贛	㔶㯯䀍䤗戅戇灨竷贛
赣	戆赣
赤	㤸䓇䚂䞰䤲䦝䬉哧捇浾焃硳赤赥赦(螫)郝𦀗𧹦𨁯
赫	㬨嚇懗爀赫
走	唗走鯐
陡	陡
足	㹱䇍䎌䛤䟽促哫娖捉浞珿莡趗足踀鋜齪龊
身	㑗㛛㧶竧裑身銵鯓鵢𠲳𨊂
躬	匑躬躳
窮	窮藭𡃕𧔚𧸺
穷	䓖穷𠴛
車	㾝䡘俥厙唓庫(褲)硨莗蛼車輋𤉖𤥭𦀺𨍦𨎆𨎠
车	伡厍库(裤)砗车𪨶
軍	㑮㟦㡓㫎㹆䝍䡣䩵䮝喗堚媈惲揮暈(𣜸𥣐)暉楎渾煇琿瘒皸皹睴禈緷翬(㩣瀈)腪葷褌諢賱軍輝運(璭)鄆鍕韗顐餫鯶鶤鼲齳𢶂𦑩𩮔
军	军恽挥晕(𦾥)晖浑珲皲翚荤裈诨辉郓
軎	軎
輦	攆輦鄻𢤠𣞶𥌦𨇍
辇	撵辇
轟	轟𡆀
轰	轰
辛	㖕㛙㲔㾕䛨厗垶峷莘(䅸)觪辛鋅锌騂骍𦐹
辜	䐻嫴橭辜
辟	㠔㱸㵨䁹䌟䑀䡶䴙僻劈噼壀壁(𢸵𧕀)嬖幦廦憵擗擘檗(蘗)檘澼璧甓癖礔礕糪繴臂薜襞譬躃躄辟避鐴鐾闢隦霹鷿鸊鼊𩼢
辡	㦚㵷㸤瓣辡辦辨辩辫辬辮辯(䉸)
办	办
辥	㔎孼嶭櫱糱薩蠥辥
薛	㔑㜸(巕)孽(𢌎𪓈)糵薛蘖躠
薩	薩
萨	萨
辭	辭
辞	辞
辰	㖘㫳㰮㲀䀼䆣䟴䢅䢈䣅䫃侲唇(滣𩺦)娠宸屒帪振(䳲𠺲)敐晨(鷐)曟桭浱祳脣(䔚䥎漘)脤莀蜃蜄裖誫賑赈辰辴鋠陙震(𢤟𤂪)麎
辱	㦺䅶傉嗕媷搙槈溽縟缛耨(𣟪𤒛𧂭)蓐褥辱鄏鎒𠢑𢟹𣜻𤍇𤹘𧏯𨃽
農	㺜䁸䃩䢉䵜儂噥嶩憹擃檂(欁)濃(𤒚)燶癑禯穠繷膿蕽襛譨農辳醲鬞齈𥵛𧓅𨆞𨐺𪇌𪒬
农	㶶侬农哝浓秾脓𬪩
辵	辵
追	㗓㷟㾽䊚䨨䭔塠搥槌磓縋缒膇追鎚𢟋𧏴𩠱𩺬
退	㾼煺腿螁褪蹆退𠑉𠺙𢟔𣻇𦤮𩘩𩘬
送	送鎹餸𩠌
逐	㯌䮱篴蓫逐鱁𠦹𠽖𢴊𧏿𨔿
造	䎭䒃䔏䗢慥簉糙造𡠻𡮯𢳥𧷹𨄹
逢	㡝㦀㷭㻱䗦䗬䙜䡫䩼塳摓槰漨熢篷(𣠑)縫(蘕)缝膖蓬(纄鑝𡓄𢩣𢸚𤂧𤑫)蠭逄逢鏠韼鬔𩅛𩙹
連	㜕㦁㰈䃛僆嗹慩摙槤漣璉縺翴蓮(櫣𡣻𤪼)褳謰蹥連鏈鰱𦟪𧐖𨕭𨖲
连	梿涟琏莲裢连链鲢
進	䗯璡進
暹	暹
逸	逸𣾹
遂	㸂䍁䡵嬘旞檖澻燧璲礈禭穟繸襚譢遂邃鐩隧𨆏𫟦𬭼
道	㘏䆃噵導檤道𠿱𥽌
导	导
遣	䪈䭤儙繾缱譴谴遣鑓𨇀
邑	㛕䇼䓃䣉䭂䯩䱒俋唈悒挹浥裛邑鄓𧋾𧠅𨁲𨛗
邕	㜉㴩嗈邕郺齆
雝	廱灉癰雝
雍	㒕㙲㻾㽫䗸噰壅(𡄐𤃟)擁(𡃵)澭甕(𨇹)癕罋臃蕹雍饔𢶜𥀪𩍓
那	㑚哪娜挪梛那𤶸𥭵𦀨𦰡𩈩
邦	䦁垹帮幚挷梆綁绑邦𠳐𢀥𣵮𥮇𨧜
郭	㗥㨯㬑䁨墎崞廓椁槨漷郭霩鞟鞹𪅪
郵	郵
都	嘟都𡳢𡳣𡳤𡼞𢵋𣛭𥳉𧹼𨅮𨗊𩼁
鄉	㗽䦳嚮曏膷薌蠁鄉響饗鱜
乡	乡芗蚃飨
酉	㾞䣭唒庮梄槱綇莤輏逎酉酒(䲤鿐)醜(𢹧𩽤)𠥤𢭳𥆺𨁪𨣥𬌲
酋	㥢㷕㻥䠓䲡偤媨崷揂楢湭煪猶(蕕)猷禉緧蝤蟗蠤趥輶遒酋鞧鰌𣜃𪍑𬨎
酓	㜝㱃䨄䳺盦酓韽
釁	亹(𧄸)璺虋釁
衅	衅
釆	釆
采	㥒䌽䐆䣋䰂倸啋埰婇寀彩採棌睬綵菜踩采𨨫
里	㾖䋥䤚䧉俚(𠸨𥈯)厘(喱)哩娌悝捚梩浬狸(䔆)理艃荲裏(䦄)裡貍(㦟薶霾)里釐鋰锂鯉鲤𢃇𥆼𥓄𨁫
埋	䨪埋榸𠹺𢆪𢲪𥕄𦄆𦷯
重	㡖㣫㮔䱰䳯䵯偅動(㗢㷲働慟(𡂁)憅𠘃𧜻)喠堹媑尰揰歱湩煄畽瘇種(㘒𥵾𧀑)箽緟腫董(㯵嬞懂𡀇𣿅𥣑𨆟)蝩衝褈諥踵重鍾(籦𡓯𦇮)锺隀𠏳𠽚𡈈𡮵𡮶𥔧𥠭𦩰𧰜𨤯𩅞
动	动恸
量	䭪糧量
𠩺	剺嫠孷斄氂漦犛𠩺
金	㕋㾣䋮䘳䥅䦦凎唫崟崯惍捦欽(䃢嶔廞撳𨇬)淦淾琻碒菳趛金鈙銜(㘅䕔䲗)錦(𡄎𢥅𥌹)顉鵭𥇶𥺻𩸱𫰾
钅	衔钅钦(嵚揿𫷷)锦
[⿰⿳业丷臿殳]	糳鑿
凿	凿
長	㙊䂻䗅䛫䠆䩨倀(𥱭)帳張(㙣㯑漲瘬)悵掁棖涱瓺痮粻脹萇賬鋹長镸韔餦鼚𥮲𦁢𧛇
长	伥帐张(涨)怅枨胀苌账长𬬮
門	㥃們問(蔄𢴌𣼶𥏿𥐔𦄞)悶(㦖㵍燜蕄𡮬𡮮𤺯)捫椚焛聞菛鍆門閖閩閿闅𠵘𡍜𡮆𡮉𤡌𤷱𦁺𦝋𨳒𨷈
门	们扪钔门问(㭣䠺𬜬)闷(焖)闻闽阌𡭜
閃	㨛㴸䁡䠾熌閃
闪	闪
閉	閇閉𠻻𡮣𡮤𡮥𡮩𤛞𦟼
闭	闭𡭬
閏	㠈䦞撋橍潤瞤膶閏閠𠾽𣋆
闰	润闰
閑	㯗䔵䥜嫻澖閑鷴𢡿𦠯𨅽
闲	娴痫闲鹇
閒	㗴㵎僩嫺憪撊橌燗癇瞯礀繝蔅蕑(𣟫)襉覵譋鐗閒鬜鷳[⿱竹閒](𡅌𢥣)
間	䉍僴墹橺澗癎瞷磵簡(㶕𡅉𣠰𨰝)蕳襇覸鐧間鬝鷼𡢃𡼏𢢀𢵧𤏐𧒄𧬘𨅍
间	㛠涧简裥锏间
閔	憫潣燘簢閔
闵	悯闵
閵	䉮藺(躪轥)躙閵
蔺	蔺躏
閻	㶄㿕䌪嚪壛櫩爓讇閻𥌸𧂄
阎	阎
闌	㘓㦨䃹䑌䦨䪍孄幱攔斕欄瀾爛瓓籣蘭(囒孏欗灡爤糷襽钄韊𡔔𢦂𢺤)襴讕躝鑭闌𩽥
阑	斓澜襕谰镧阑
闖	㶒闖
闯	闯
阜	㷆䘀䧞埠峊阜
阿	㢌䋪啊娿婀屙痾錒锕阿𨼼
除	㾻滁篨蒢除𢲢
陳	䨯敶樄蔯螴陳𢠣𣼼
陣	塦陣𠻆𣗑𧏶
陈	陈𫈟
阵	阵
隋	㯐䔺䜏䜐䝐䲊墮(𡃏)嫷嶞憜撱橢隋隳
[⿱左肉]	㨊㻟䤻䭉䯝堶媠惰(墯)毻鬌
隨	㰐瀡瓍隨𡃴
遀	㵦䜔䥦膸遀髓𩟆
陏	堕椭陏随
隓	隓
[⿳小日小]	虩隙𨻶{𡁸}
隶	㥆㻖䇐䠈埭捸棣殔逮(叇曃靆𩻸)隶霴齂
隸	㘑隷隸
隹	㕍(嵟)㢈㮅䧽䱦䳡䶆倠唯(嶉蓶鷕𣼲)堆(𠐸𠼲𡓋𡳪𣊌𣙇𣙯𣼭𥊖𦟿𧐻𨄟𨄺𨬉𩅚𪅧)婎帷惟推(嶊蓷𧤹)椎(𥴛𩠳)淮(匯(㒑擓))焳猚琟痽睢(濉)碓維(䗽濰)维(潍)脽萑蜼誰(䜃)谁趡踓醀錐锥陮隹雖(𡄪)顀騅骓魋鵻龨(㨤)𠥔
汇	㧟汇
虽	虽
隺	㩁㴶㹊㿥䥃䮤傕(𡑗𤏥)寉搉(𦾣)榷確(𡃜)篧蒮隺髉鶴(靏)鹤𠻓𤌍
隻	㸕䑾隻𣄥𣉲𪅥
隼	奞榫鎨隼鶽
準	準𠿶𢶥𦡤𨆒
准	准
雀	熦雀𠻘
雥	雥
集	㗱㙫㠍㠎㱷䌖潗磼穕襍鏶集𠍱𢵸
雜	䕹囃雜𫝜
杂	杂
雈	雈
雋	㰎㻽儁寯懏擕檇臇觹鐫雋𡼕
隽	㑺㝦㷪㻪䐪槜鎸镌隽𧤤
雔	㘜售犨讎(犫𢦄)讐雔雠
雙	㩳䉶䝄䨇孇愯欆艭雙𢅻
双	㧐双𨳦
雚	㩲䌯䑏䙮䚭䝔䟒䠰勸(𡅳)嚾壦孉巏懽權歡灌爟獾瓘矔礶罐虇蠸觀(欟)讙貛酄鑵雚顴颧驩鱹鸛鹳
[⿱𠂉⿻一隹]	勧権歓潅観(𣠤)𨫝𮉸
[又2]	劝权欢观
難	㬮㰙㸐(䖄)䕼儺戁攤灘癱臡難𡅧𡔃𢥪𢺋𥸁𦣎𧕴
难	傩摊滩瘫难𦟗
雨	雨
雩	㻬嫮嶀摴樗謣鄠雩
雷	㵢䍣䢮擂檑癗礌蕾鐳镭雷鱩鿨𡀂𡢽𤐝𤢗𥋸𥩉𦆙𧒽𨆢𨙝𩁦𩍢𪆼
需	㹘㽭䇕䞕䨲䰑䰰儒(𡃽)嚅嬬孺嶿懦擩曘檽濡燸獳瓀礝穤糯繻羺臑薷蠕襦譳醹鑐需顬颥鱬𠧍𤻪𥌎𦈡
霍	㱋㸌㺢嚯攉曤瀖癨皬矐礭籗臛藿霍靃鸖
霝	㪮䡼孁櫺蘦酃醽霛霝麢龗𩆜
靈	㦭䄥䉹䖅䚖䡿䰱䴒欞爧靈𣌟𤅷𤫩𥩔𨤍
灵	㻏棂灵𠴌𧼍
霸	㶚䃻䨰壩欛灞霸𣠽
青	㣏䑶䝼䞍䨝䴖倩(篟蒨)凊啨圊埥婧寈崝情掅晴棈氰淸清(蔳)猜(𢴘𧜹)皘睛(𤀜)碃箐精綪聙腈菁蜻請(𡃑)请輤郬錆锖青靓靖(𥴰)靗靘(濪)静靚(㵾儬)靜(瀞𥶹)鯖鲭鶄鼱𤎓𦑊𩇕𬘬
非	㐟㫵㯇㰆㹃㻗䠊䤏䤵䨽䨾(𢳁)䩁俳剕匪(㥱榧篚𠌨)厞啡奜婓婔屝徘悱扉斐(𢵪)暃棐(䕁)棑毴渄(𩄼)猆琲痱緋绯翡腓菲(㔈蕜)蜚裴(𦢄)裵裶誹诽輩輫辈陫霏非靟餥馡騑鯡鲱𤊬𩇫
悲	悲𠎩𠾦𣊾𣛥𤮑𨅥𨭍𨼚𩙻𩻺
排	排𠄽𠍣𠼕𡀪
面	㮌䤄䩄偭勔喕媔愐湎糆緬缅腼蝒蠠面靦麵麺𤟯
靣	靣𠡳
革	㗆㮖㴖䐙䨣䪂䳬愅煂緙(𡃈)缂諽革鞂韚
韋	䍷䪘偉喡圍(䙟潿𩼀)媁幃徫愇暐椲湋煒瑋禕稦緯葦褘諱違(𨗨)郼鍏闈韋韑韙韡颹𢯷𥯤𩏳
韦	㭏伟围(涠)帏炜玮祎纬苇袆讳违闱韦韪𣲗𬀩𬬬𮧵
韭	韭韮
韱	㡨㺤䃸䆎䊱䑎䘋䤘孅懺攕櫼殲瀸(虃)籤纖襳讖谶鑯韱𣱰𩆷
韯	㩥㰇䃱䘂䜟懴殱瀐籖纎韯
音	㛺䅧䜾䤃䪪䬓偣喑(𤺵)堷愔揞(𣚮)暗(𢶹)歆(噷嬜𢣇𣋚𤐚𤻐𥋵𥵗𨮈)湆(湇)瘖窨(噾)罯腤萻諳谙闇隌音韽韾鶕黯鿷𤋾𤭵𥃚𥃛𦂺𩄒𩆢𩩿
頁	䋶(㩪)蝢頁鿓
页	页鿒
頃	㯋䔛傾廎潁(㩩)熲穎(蘔𡓡𤃡)頃頴(蘏)顈𠼴𩓙
顷	倾庼顷颍颎颕颖
須	䅡䇓嬃暊盨蕦須鬚𣌌𣛪𩅺𪆦
须	媭须
[⿷匚⿳丨口丨]	㺇㺿㼢䇫䱌姬宧弬洍茝頤颐
頪	纇頪類(禷蘱)
类	类
頻	㰋嚬瀕蘋頻顰
频	濒频颦𬞟
顥	灝顥
颢	灏颢
風	䑺䬚偑堸嵐(𨅏)楓檒渢煈猦瘋碸葻(𡑵𢶻𣜳𤀘𨮇)諷闏風颿飌𡺤𢱚𣄖𩂑𩄏𩖫
风	㐽岚枫沨疯砜讽风
飛	䙍䬠榌飛騛𢝵𢞵𩹉
飞	飞
饣	蚀饣饬饰
食	䓹蝕食飤飭(𠿰)飾(籂)餝
首	䭭艏衜衟道首
香	㴡䅨䦭楿萫香麘𡎟𥧎𧯄𧯅𧹰
馬	㾺䣕䧞䭾傌嗎媽榪溤獁瑪碼禡罵螞遤鎷馬駡(𣟭𦢷)鰢鷌𡏢𢲫𣜋𥡗𦄀𦟐𧜗𩦓
马	㐷䘞吗妈杩犸玛码祃蚂马骂
馭	馭𤺶
驭	驭
[爻]	駁(㘐礮)驳
骨	㾶䮩䯇䯉䱻䶤傦嗗尳愲搰榾滑(𠿭)猾磆縎蓇螖顝餶馉骨鶻鹘𠞡𠬒𥐒𥱪𨃴𩄨𪄥
高	㙜㾸䐧䧚䬘䮦䯨䯩䯪䯫傐嗃塙嵪搞敲(𡁞)暠槀(燺)槁(𡂀)歊(藃)毃滈(薃)熇犒皜碻禞稾稿篙(㰏)縞缟翯(瀥)膏(𧀎)蒿(嚆薧藁藳)謞鄗鎬镐髇高髚髜(巐)鰝鶮𠞟𢲤𣉞
毫	毫𣻼𧐢
豪	㠙㩝䧫儫嚎壕檺濠籇蠔譹豪
髟	髟
鬥	鬥
鬧	鬧
閙	閙鬧𠿷𢷃𤐛
闹	闹
鬩	鬩
䦧	㦦䦧
阋	阋
鬯	鬯
鬱	㠨䖇欝灪爩鬱𡯀
鬲	㣂㬏䃒䈪䙐䛿䣓䩹䮥䰛嗝塥搹槅滆翮膈蒚鎘镉隔鞷鬲鬴鷊(虉)鹝(𬟁)𤮄
鬳	甗鬳
獻	㩵䡾囐巘巚獻瓛讞钀齾𧖃
献	擜献谳𤩽𪩘
鬼	㟴㱱䁛䈭䌆䫥䴜傀塊(𤐡𤮟)媿廆(䕇)愧槐(𥖸)溾瑰(𧀐)瘣(藱)磈聭螝褢謉隗(㠕)餽騩鬼鬿魁(櫆𡦶𤁔𪇫)𠺌𤌋𥶯𦞙𩱻𩲡
嵬	㠢䃬嵬𠑖𠿯𡓮𡾵𢢯𢶟𢶼𣰏𤀖𤐜𤮞𥋳𧥇𪇋
魚	䁩䐳䔡䗨䰻䱷漁魚鷠𠽐𡐚𢠐𣊘𤹿𩵾𩺋𩺰
鱼	渔鱼
魝	薊魝
蓟	蓟
魯	嚕擼櫓氌瀂穭艪鑥魯鿩𠐔𠓑𡓇𣋼𤑟𤻼𥌧𥩍𥶇
鲁	噜撸橹氇澛穞镥鲁
鮮	㶍䇁䉳廯癬蘚鮮
鲜	癣藓鲜
[眔]	䤽瘝鰥(㱎)鳏
鳥	㨶䉆䲽嶋嶌樢瞗窵蔦隝鳥鵃𠞸𠟀𡡅𧜣𪆐𪆤
島	島搗﨩𦃭
鸟	㭤窎茑鸟
岛	岛捣
鳴	鳴
鸣	鸣
鹵	㔪㲶塷樐滷磠蓾鏀鹵𢲸
卤	卤硵
塩	塩
盐	盐
鹿	㜙㦇㼾䃙䌒䍡塶廘摝樚漉熝簏膔蔍螰蹗轆辘鏕騼鹿麓
麀	䥝鏖麀
麃	㩠䮽儦瀌爊犥皫穮臕藨鄜鑣镳麃𤣄
麗	㿛䕻䚕儷囇孋廲彲攦曬欐灑矖穲籭纚襹躧邐酈釃驪鱺鸝麗𪈳
麥	䥑䨫䮮嘜麥𪄳
麦	唛麦鿏鿺
麻	㦄䌕䗫䜆䩋䯢䲈䳸嘛塺嫲摩(嚤擵藦)犘痲磨(嚰礳耱蘑饝)穈糜(醾)縻(䕷䭧醿)蔴髍魔麻麼(嚒嬤)麽(嬷懡)麾𢠩𣊍𣙪𣻕𤎎𥊚𥢂𦓡𧫼𨬈
靡	㠧㸏䃺䊳䭩劘孊戂攠灖爢蘼釄靡
么	䶸么仫𡚸
黃	䤑僙墴彉撗橫潢熿獚璜癀磺穔簧蟥觵趪鐄鱑鷬黃黆黌𠾛𧝒
黄	䊣䌙䐵䪄䬝䮲䵃曂横(㶇)黄黉黋𨱑
黍	潻黍
黑	㩏㱄䁫䆀嘿嫼潶蟔黑黒黓默(䁿𧞾)黙(𢹇)𨊂𨭆𪐷𬭶
墨	䁼䘃嚜墨濹爅癦纆𣞪𦢓𦪷𬙊
黹	黹
黽	䵴僶憴澠繩(𡅠𥶀)蠅譝鄳鱦黽鼆
黾	䋲渑绳蝇黾𠊟𫑡
鼎	䵺檙濎薡鐤鼎
鼓	皷瞽臌薣鼓
鼠	癙鼠
鼻	䑄䕗䫁嚊嬶濞襣鼻𡽶
齊	㸄䍤䜞䭣䶒䶓䶩儕劑嚌懠擠櫅濟璾癠穧纃臍薺蠐賷躋隮霽韲(虀)鱭麡齊齋齌齍齎齏𡣙
亝	㴉䠁亝
斉	㑪㨈斉済緕萕𦜝
齐	侪剂哜挤斋济脐荠蛴赍跻霁鲚齐齑
龍	㰍䆍䏊䡁䪊䮾儱嚨壟壠寵巃攏曨朧櫳瀧瓏矓礱竉籠聾蘢蠪襱豅贚躘隴靇驡鸗龍龏龐龓龔𢤱𣰵𪚤
龙	咙垄宠庞拢昽栊泷珑眬砻笼聋胧茏陇龙龚
竜	滝(𤁘)竜𠺠𢲣𣯡𤄯𥉩𥉫𨃸𩄱
龖	龖
[龍]	襲讋
[龙]	袭詟
龜	䶯䶰櫷鬮龜𩰘𪚩
龟	阄龟
龠	㒢㵸䟑䠯䶳瀹爚禴籥蘥讑鑰鸙龠龥(籲)
龹	䄅䖭券劵(椦)帣弮拳(搼)桊牶眷(慻膡𡡀𨖩)絭(勬潫)觠豢(㹖)韏飬餋齤龹
𡈼	䦐𡈼𨳝
丌	丌
亓	亓
勒	勒嘞簕鰳鳓𣼷𤨕
曆	暦曆𤃝
宏	宏峵浤硡竤綋翝鋐𨌆𬭎
急	㴔喼急𢰽𤌀𥈲
𠂇	𠂇
卡	佧卡咔拤胩鉲
[厶]	
䍜	䍜
# 避免使用禁止顯示字，用下轄的代表字形替代之
# 比原版少哪些字
# 建立面對對象的轄字樹
# 對爭議字形明確/修改對應聲首
# 確定需要新增（替換）的溢出字形
# 對於不用轄字樹最根部聲首的字，列出這些非根部聲首
# 原則：常用字的複雜度減少
# 去重
# 作爲部首的有多個Unicode編號的字，康熙部首不需要動